.com.solocator.solocator	Solocator - GPS Field Camera
2EUQ92MT46.com.4yourtype.btd	Blood Type Diet®
4GU63N96WE.com.p5sys.jumpdesktop	Jump Desktop (RDP, VNC, Fluid)
4MYYV8G5VR.com.netspend	Netspend
8K2NU5962N	DontSpy 2 - detector
9W73MG866C.net.grand-unified.Woodshop	The Woodshop Widget
AA7872LANF.com.redenes.lacuerda.iphoneapp	LaCuerda [PRO]
AG.Activity-plus	Activity+
AP-Journey	Journey
Apptly.Oldify2	Oldify - Old Face App
Battleheart	Battleheart
Bret-H.-Hardman.QuickBend	QuickBend: Conduit Bending
BuildApp.JajaPoker	Poker Heat: Texas Holdem Poker
COM.ForwardLeapSoftware.KitchenPRO	Kitchen Calculator PRO
CesarKuriyama.OneSecondEveryday	1 Second Everyday: Video Diary
Clemson-University.Romulus.Euro	Romulus Euro
Clemson-University.Romulus.US	Romulus APUSH Review
D4D2433BGC	Keeper Password Manager
DiqIndustries.Omnitrix	Alien10
EN4W9JR9G5.au.id.nickrobinson.bookofshadows	Book of Shadows
Eden	Eden - World Builder
Florence1	Florence
Futureapps.Hidden-Camera-Detector	Hidden Spy Camera Detector
GILBERT.COM.AI	Pick Finger Game
GONEHOME	Gone Home
Glauco.RecordingStudioPro	Recording Studio Pro!
H5G.High5GamesLobby	High 5 Casino: Home of Slots
HardTimeVIP	Hard Time VIP
HoF-Slots	House of Fun: Casino Slots 777
InkHunter.inkHunter.pro	INKHUNTER PRO Tattoos try on
InstaSize	Instasize Photo Editor + Video
J39RVBR353.jp.co.taito.spaceinvaders	SPACE INVADERS
JIFF.GifJiff	GifJif - Custom Gif Creator
LightSpectrumPro	LightSpectrum Pro
MSPMobile	MovieStarPlanet
MitchWaite.iBirdPRO	iBird Pro Guide to Birds
My-PlayHome	My PlayHome
Newinventer.Censorfy	Beep - Censor videos easily
Nexu-Industries.THE-ESO-APP	The ESO App
Pikalytics.Pikalytics	Pikalytics: Battle Strategy
PocketLabs.PocketUniverse	My Pocket Galaxy - 3D Sandbox
PrintedProps.Dokk-OS	Dokk OS
Q5AWL8WCY6.iMapMyRun	Map My Run by Under Armour
R6WLZBVJLW.ChessPremium	Chess Premium
RainAware-LLC.RainAware	RainAware Weather Timer
RunKeeperPro	Runkeeper—GPS Running Tracker
SchoolPrivate	Private School Days
SilverCastle.MobileHitBTC	Mobile HitBTC
SpaceAgency	Space Agency
SpotMap.Airchat	Fam - Group Live Stream
SuperCitySpecial	Super City: Special Edition
Sydvesti.Coloring-Watch	Coloring Watch
Sydvesti.HRV-Tracker	HRV Tracker for Watch
US.Luxy.Luxy	Luxy- Selective Dating
US.Luxy.LuxyHD	Luxy PRO: Selective Dating
WRPro	Wrestling Revolution Pro
Y23S4CGVUD	AyeTides
YSOFTWARE.LocationFaker	Location Faker - Ultimate Edition
Zhandos-Uakanov.Booster	Cellular Antenna Booster
afl.chromecast	Chromecast Streamer
age.of.civilizations2.jakowski.lukasz.ios	Age of History II
ai.replika.app	Replika - My AI Friend
ai.undefined.fit-by-katy	FIT by Katy
aiby.prowidget	Themify - App Icons & Themes
air.SugarSugar	sugar, sugar
air.com.sfbgames.HauntTheHouseTerrortown	Haunt the House: Terrortown
air.zoi.ponycreator	Pony Creator
alexandrudenk.Dark-Mode-for-iOS-Safari	Dark Mode for Safari
alexuvarov.BennetTest-Full	Bennet Test Full
am.impossible.hear-my-baby	Hear My Baby Heartbeat App
am.impossible.sk.caterham	Street Kart Racing - Simulator
amanita-design.samorost2.ios	Samorost 2
app.FootWare.Shift	Shift Keyboard - Swipe & Type
app.FootWare.TV-Remote	TV Remote - Universal Remote
app.beerbuddy.ios	Beer Buddy - Drink with me!
app.hallow.Hallow	Hallow: Catholic Meditation
app.howly.ios	2nd1st -Uncensored News & Chat
app.kryds.game	Kryss - The Battle of Words
app.scanz	Scanner app : scan documents
app.walpapers	Live Wallpaper Maker - Live4K
archery.storify	Mojo - Insta Story Editor
areopagitics.bible	Interlinear Bible
art.sandbox.app	Sandbox - Pixel Art Coloring
at.blink.denoncontrol	DeRemote for Denon and Marantz
at.classyh.ftakit	FTSearch - Fast Track Bid Tool
ata.tuna.pimd	Party in my Dorm: College Game
au.com.andrewchin.nomi	nomi | a pet for your watch
au.com.metro.DumbWaysToDie	Dumb Ways to Die
au.com.savageinteractive.procreate-pocket	Procreate Pocket
ball.magnet.ico	Magnetico: Bomb Master 3D
binance.calculator.profit	Crypto Profit Calculator
biz.faxapp.app	FAX from iPhone - send fax
biz.p3media.BloodSpatterAngleCalculator	Blood Spatter Angle Calculator
blast.boom	Cube Rush Adventure
bp.callrecorder.free	Call Recorder App: RecMyCalls
bp.ft	Find Friends, Phone - FindMe
bp.rmaster.free	Smart Cleaner - Clean Storage
bp.sphone.free	Second Phone Number - 2Number
brownmonster.app.game.rushrally3	Rush Rally 3
bushev.ssh.tunnel	SSH Tunnel - with SOCKS5 proxy
ca.lbcstudios.hempire	Hempire - Weed Growing Game
ca.psiphon.Psiphon	Psiphon
caitlin.finn.30WholeDays	30 Whole Days
call.free.international.phone.call	Second Phone Number -Texts App
cam.neural.night.photo	NeuralCam - Night Mode Camera
cc.peacedeath.peacedeathapp	Peace, Death!
ccw	CCW – Concealed Carry 50 State
celebrity.voice.changer.best.voice.fx.funny.effects.soundboard.free	Celebrity Voice Changer - Face
ch.feinheit.games.firststrike	First Strike: Classic
ch.peakfinder.peakfinder-alps	PeakFinder AR
ch.threema.iapp	Threema. The Secure Messenger
champions.empire.bubble	Bubbles Empire Champions
circuitColors	Circuit Colors
club.luckylimited.iScan	iScan - PDF & Document Scanner
cn.danatech.xingseus	PictureThis - Plant Identifier
cn.phoenix.game.ios.pr	蓝颜清梦（全球版）
cn.shanchuan.shanchuan	Xender:File Share,Share Music
co.7er.baby-lock	Baby Lock Screen For Youtube - Child Locker
co.9count.wink	Wink - make new friends & chat
co.DilMile.DilMile	Dil Mil - South Asian dating
co.TechPositive.GlassifyMe	Pupil Distance PD Measure
co.alphaexploration.clubhouse	Clubhouse: Drop-in audio chat
co.aviagames.bingo	Bingo Clash: win real cash
co.bazaart.app	Bazaart Photo Editor & Design
co.bird.Ride	Bird - Be Free, Enjoy the Ride
co.clover.clover	Clover Dating App
co.fabrizio.coolors	Coolors
co.happybits.marcopolo	Marco Polo - Stay in Touch
co.hinge.mobile.ios	Hinge: Dating & Relationships
co.infinitysoft.vpn360	VPN 360 - Unlimited VPN Proxy
co.loona.ios	Loóna: calm, relax and sleep
co.lushapp.lush	Lush Cocktails
co.mixcord.acapella	Acapella from PicPlayPost
co.momentlens.moment	Pro Camera by Moment
co.newcode.pocket7games	Pocket7Games: Win Cash
co.offtime.OFFTIME	OFFTIME: Unplug and disconnect
co.pamobile.mcpe.addonsmaker	AddOns Maker for Minecraft PE
co.raptech.studios.rap.fame	Rap Fame - Rap Music Studio
co.robokiller.app	RoboKiller: Block Spam Calls
co.sleepguru.sleep	Guru: Stories & Meditation
co.tc.mobile	TrapCall: Reveal No Caller ID
co.thefabulous.app	Fabulous - Daily Self Care
co.visualsupply.cam	VSCO: Photo & Video Editor
co.yellw.Yellow	Yubo : Make friends & Go live
co.yogabuddhi.YogaBuddhi	Yoga | Down Dog
com.10klakessoftware.swimmetry	Swimmetry
com.10tons.UndeadHorde	Undead Horde
com.11bitstudios.twommobile	This War of Mine
com.11bitstudios.twomstories	This War of Mine: Stories
com.1button.mrsuper	The Superhero League
com.1button.ricochet	Mr Bullet - Spy Puzzles
com.1debit.ChimeProdApp	Chime – Mobile Banking
com.2048media.nfhsnetwork	NFHS Network
com.21awake.buddhify2	buddhify: meditation on the go
com.22learn.AbbyBasicSkillsHD	Abby Monkey Basic Skills Pre K
com.2KSports.WWE2K14Mobile	WWE SuperCard - Rule the Ring
com.2dboy.worldofgoo	World of Goo
com.2hours.Memong	Memong
com.2k.civrev2	Civilization Revolution 2
com.2k.xcomew	XCOM®: Enemy Within
com.2ksports.mynba2k21	MyNBA2K21
com.2ksports.nba2km	NBA 2K Mobile Basketball
com.2ndnumber.app	2ndLine: Second Phone Number
com.2star.pusher	Pusher 3D
com.3d4medical.EssentialAnatomyiPad	Essential Anatomy 5
com.3d4medical.iMuscleiPhone	iMuscle 2 - iPhone Edition
com.3donkeys.loveBits	Love You To Bits
com.3kbother.midas	MIDAS - 4K LIVE FILTER CAMERA
com.3kbrother.reco	RECO - 4K VIDEO & FILM FILTER
com.3minutegames.lifeline	Lifeline...
com.3minutegames.lifelineflatlineaapl	Lifeline: Flatline
com.3nder.threender	Feeld: Online Dating & Chat
com.44sevenmedia.75hard	75 Hard
com.4wrdtech.netflixhack	Unlocked for Netflix
com.501.jumpdunk	Jump Dunk 3D
com.505games.humanfallflat	Human: Fall Flat
com.505games.terraria	Terraria
com.6DegreeLabs.apps.Likewise	Likewise: Movie, TV, Book Recs
com.7pirates.infinitywar	Ark of War:Galaxy Pirate Fleet
com.7thbeat.adofai	A Dance of Fire and Ice
com.9031.fliqlo	Fliqlo
com.ASA.SailingGame	ASA's Sailing Challenge
com.ASRA.ASRACoags	ASRA Coags
com.AgainstGravity.RecRoomBeta	Rec Room
com.Alawar.FarmFrenzy3	Farm Frenzy 3. Farming game
com.AlexNaronov.LD	Line Driver - Draw and Ride
com.AlexReutov.SaveTheBaby	Save the baby - Adventure game
com.AngelaHe.anewlife	a new life.
com.AppActual.Stamena	Stamena - Longer lasting sex
com.AppliedBallistics.Iphone	Applied Ballistics
com.Apps4Life.Spacie	Spacie - Clean Line Breaks
com.Asilbek.BapeWallpapers	Dope Wallpapers HD Cool Screen
com.Atinon.PassOver	Cube Surfer!
com.AuraMobile	Aura: Meditation & Sleep
com.BallGames.Woodturning	Woodturning 3D
com.Birdentifier.BirdGenie	BirdGenie
com.BlackjackApprenticeship.BJATrainerPro	Blackjack & Card Counting Pro
com.BlitzAppDevelopment.RiffleRaffle	Riffle Raffle
com.CaelumAudio.Beef	Beef
com.Campless.Campless	StockX - Buy & Sell Authentic
com.Celltop.SpiralRoll	Spiral Roll
com.ChillSeekers.Necrophonic	Necrophonic
com.Chris-Dahdouh.optionsApp	StockOrbit
com.ClassDojo	ClassDojo
com.D3Go.mendel	Alien: Blackout
com.DamianBernardi.LawsofCivilization	Lawgivers
com.DataRiver.PrimosSTL	Primos Hunting Calls
com.DefaultCompany.KnightsOfRound	Fallen of the Round
com.DefiantDev.SkiSafari	Ski Safari
com.DgnGames.OldVegasSlots	Old Vegas Classic Slots Casino
com.DrawMeAPixel.TingWD	There Is No Game: WD
com.Easy-Offset	Easy Offset
com.Epocrates.Rx	Epocrates
com.EthanRobbins.Card-Scan	CardScanApp
com.EtherGaming.PocketRoguesUltimate	Pocket Rogues: Ultimate
com.ExamFX.ExamFXHealth	ExamFX Health Exam Prep
com.ExamFX.ExamFXLife	ExamFX Life Exam Prep
com.ExamFX.ExamFXLifeHealth	ExamFX Life & Health Exam Prep
com.ExamFX.ExamFXPropertyCasualty	ExamFX Property & Casualty Exam Prep
com.ExamFX.ExamFXSeries7	ExamFX Series 7 Exam Prep
com.FDGEntertainment.Oceanhorn	Oceanhorn ™
com.FDGEntertainment.RedBall4	Red Ball 4
com.FDGEntertainment.Slayin	Slayin
com.FYQD.BrightMemory	Bright Memory Mobile
com.FenderDigital.Play	Fender Play - Guitar Lessons
com.FetchRewards.HopBeta	Fetch: Rewards On All Receipts
com.FireproofStudios.TheRoom2	The Room Two
com.FireproofStudios.TheRoom3	The Room Three
com.FireproofStudios.TheRoom4	The Room: Old Sins
com.FlamebaitGames.Passpartout	Passpartout: Starving Artist
com.FlatEarthSunMoonClock	Flat Earth Sun, Moon & Zodiac
com.FlukeDude.TheImpossibleGame	The Impossible Game
com.Flyfishing.RiverLegends	River Legends
com.Followers.Tool.app	Follower track for Instagram
com.Funimation.FunimationNow	Funimation
com.GF.palacem5uscn.hwyios.app	Fate of the Empress
com.GODpeople.BIBLE	갓피플성경
com.Garawell.BridgeRace	Bridge Race
com.GeoGuessr.iOS.GeoGuessr	GeoGuessr
com.GhostHunterXL	Ghost Detector: Spirit Hunter
com.Ginger.Ginger	Ginger Grammar, Spellchecker
com.GonnelliDomenico.FirebaseApp	FirebaseApp
com.Grant151.habit-tracker	Finale: Daily Habit Tracker
com.HKONS.LT-Sounds	LT.SOUNDS
com.HP.PregnancyiPhonelite	Pregnancy +
com.HSSN.VisAnatomy	Visual Anatomy
com.Halfbrick.Fruit	Fruit Ninja Classic
com.HardRock.HardRockSocialCasino	Hard Rock Social Casino
com.Homer.HomerLearning	HOMER Learn & Grow
com.HorizonsCompanies.JegsApp	JEGS Perfect Start
com.Icogno.CleverbotB	Cleverbot
com.IfThenDev.BookScanner	BookScanner App
com.InterstitialCystitisNetwork.icnFood2011	ICN Food List
com.JadonBarnes.FunWithRagdollsTheGame-iOS	Fun with Ragdolls
com.JazzaStudios.JazzasArtyGames	Jazza's Arty Games
com.JesseHeffels.GameofFLIP	Game of FLIP
com.JindoBlu.AntistressIOS	Antistress - Relaxing games
com.JonathanMelnik.BlockTapTap	Block Tap Tap
com.KaueRosa.CityTakeover	City Takeover
com.KelliNoda.Zombieville	Zombieville USA
com.Kleientertainment.dontstarveshipwrecked	Don't Starve: Shipwrecked
com.Kylan.StudyABA	ABA Wizard
com.Kylan.StudyBT	ABA Wizard: BT Exam
com.KyleFowler.Cardstock	Cardstock: Sports Card Scanner
com.LDRLY.budfarmidletycoon	Bud Farm: Idle Tycoon Game
com.LDRLY.cheechandchong	Cheech and Chong Bud Farm
com.LTML.Flipgrid	Flipgrid.
com.Level5.LT1RNA	Layton: Curious Village in HD
com.LionDogApps.Dressage-TestPro-USDF	TestPro US Dressage Federation
com.LomotifPteLtd.Lomotif	Lomotif: Edit Video. Add Music
com.Lougheed.GoalHornHub	Goal Horn Hub
com.Lovely.SalesFormal	LovelyWholesale-Shopping
com.LynnField.MilitaryRetire	Military Retirement
com.MMApps.WidgetsApp	Color Widgets
com.MPixels.GravityNoodle	Gravity Noodle
com.Mad.DuckLifeBattle	Duck Life: Battle
com.MarcusNg.Dog	Dog Assistant - Potty Training
com.Marz-Software.iPush-Up-Counter-Pro	PushFit Pro
com.MegaJoy.PrisonBreak68	Prison Escape: Stickman Story
com.Melesta.MyCafe	My Cafe — Restaurant game
com.MelsoftGames.FamilyIsland	Family Island — Farming game
com.MikaMobile.Zombieville2	Zombieville USA 2
com.MirageLabs.MoviePro	MoviePro - Pro Video Camera
com.Mobge.Oddmar	Oddmar
com.Monash.FODMAP	Monash University FODMAP diet
com.MonkeyTaps.IAM	I am - Daily Affirmations
com.MonkeyTaps.Motivation	Motivation - Daily quotes
com.MontanaGames.LowridersComeback2Cruising	Lowriders Comeback 2: Cruising
com.MotoJitsu.Books	MotoJitsu
com.MountainTreeStd.Musicfighter	Music Fighter Whitty FNF Game
com.NewGeoGameRNI	GeoGuesser 2
com.Nicalis.Isaac-iOS	The Binding of Isaac: Rebirth
com.NordUnit.HYPERFORMA	Hyperforma
com.NovaSoftInteractive.Meridian157-Ch1-Distribution	Meridian 157: Chapter 1
com.OdinInteractive.DetectiveMasters	Detective Masters
com.OgtusMedia.Sound	Baby Ultrasound 2015
com.Peloton.PelotonApp	Peloton — at home fitness
com.PepiPlay.PepiHospital	Pepi Hospital: Learn & Care
com.PepiPlay.PepiShopping	Pepi Super Stores: Fun & Games
com.PixelForceSystems.SweatWithKayla	Sweat: Fitness App For Women
com.Pizia.VoodooDoll	Voodoo Doll
com.PlausibleConcept.BadNorth	Bad North: Jotunn Edition
com.Popshow.YOLO	YOLO: Anonymous Q&A
com.ProfiSoft.EthanolMix	E85 Mix Ethanol Calculator
com.RBSSOFT.HyperMobile	Chat Master!
com.RCA.PipeDataBase	Piping DataBase - XTREME
com.RK.BikesHill	Bikes Hill
com.RaceRenderLLC.TrackAddict	TrackAddict Pro
com.RedLineGames.Game49	Ice Cream Inc.
com.RocketGames.ClassicSlots	Viva Slots Vegas Slot Machines
com.RocoInfo.Kis	Ahlan - Group Voice Chat Rooms
com.RoosterGames.Construct2	Handyman! 3D
com.RustyLake.RustyLakeHotel	Rusty Lake Hotel
com.RustyLake.RustyLakeParadise	Rusty Lake Paradise
com.RustyLake.RustyLakeRoots	Rusty Lake: Roots
com.RustyLake.TheWhiteDoor	The White Door
com.SEB.WarholFX	PopArt FX
com.SawyerBlatz.Nudget	Nudget: Spending Tracker
com.Seriously.BestFiends	Best Fiends - Puzzle Adventure
com.SideChef.SideChef-iphoneParter	Budget Bytes
com.Soferio.SenGram	SenGram - Sentence Diagramming
com.StudioGoya.ChessSudoku	Chess Sudoku
com.StudioGoya.ClassicSudoku	Classic Sudoku!
com.TAV.ShipHandling	Ship Handling Simulator
com.TGSoftware.NoteRush	Note Rush: Music Reading Game
com.TadaoYamaoka.VocalPitchMonitor	Vocal Pitch Monitor
com.TailoredMusic.Rainy-Mood	Rainy Mood
com.Tap2Jump.GarbageTruck3D	Garbage Truck 3D!!!
com.TapMediaLtd.QRReader	QR Reader for iPhone
com.TapMediaLtd.VoiceRecorderFREE	Voice Recorder & Audio Editor
com.Team17.TheEscapists2	Escapists 2: Pocket Breakout
com.TechSmith.CoachsEye	Coach's Eye - Video Analysis
com.TheBarringerGroup.Critical	Critical- Medical Guide
com.ThomasTsopanakis.Counters	Tally Counters
com.ThunderGameWorks.Trenches2	Trenches II
com.Tipsy.CardGenie	CardGenie - Sports Cards
com.TomorrowCorporation.LittleInferno	Little Inferno HD
com.Trucker-Path-Pro	Trucker Path: Truck GPS & Maps
com.UmamiGames.Scattergories	ABC Runner
com.UnlitGames.BridalRush	Bridal Rush!
com.Upperpik.HairChallenge	Hair Challenge
com.VidAngel.TheChosen	The Chosen: Jesus TV-Show
com.VideoShop.VideoShop	Videoshop - Video Editor
com.VoxelGames.BigHit	The Big Hit
com.Whataburger.Production	Whataburger
com.WildWorks.AnimalJamPlayWild	Animal Jam
com.YoStarEN.Arknights	Arknights
com.YoStarEN.AzurLane	Azur Lane
com.YsoCorp.StretchGuy	Stretch Guy
com.YsoCorp.WhoAmI	Whooo?
com.YunFang.PhotoGrid	PhotoGrid Video Collage maker
com.aa.AmericanAirlines	American Airlines
com.aa.lockemsandman	Plunger Hero
com.aaa.iphone.discounts	AAA Mobile
com.aaagame.classicvegasslots	Classic Casino Slots Games
com.aaagame.goldencasino	Golden Casino - Vegas Slots
com.aabigbook.appstore	AA Big Book App  -  Unofficial
com.aaronpearce.HomeRun	HomeRun for HomeKit
com.abercrombie.hollister	Hollister So Cal Style
com.abishkking.maleworkout	Home Workout - No Equipments
com.abishkking.periodcalendar	Period Tracker Period Calendar
com.abscbni.tfctv	iWantTFC
com.abundanthealth4u.RefGuide4EO	Ref Guide for Essential Oils
com.abylight.hyperlightdrifter	Hyper Light Drifter
com.accordmobi.ios.callrecorder	Call Recorder for iPhone.
com.accordmobi.ios.scanner	Scanner App: Scan Docs, Notes
com.aceable.AceableDrivingDE	Aceable – Driving School App
com.acg.usios.en.e1	Super Saiyan Fighter
com.acidremap.ParamedicProtocolProvider	Paramedic Protocol Provider
com.acorns.investor	Acorns: Invest Spare Change
com.actgames.amg.ios.gl	Bangbang Rabbit!
com.active.c25k	Couch to 5K® - Run training
com.activehours.Activehours	Earnin: Get $100 Before Payday
com.activepackets.talkpok	Psychic Txt - Live Readings
com.activision.callofduty.blackopszombies	Call of Duty: Black Ops Zombies
com.activision.callofduty.companion	Call of Duty Companion App
com.activision.callofduty.shooter	Call of Duty®: Mobile
com.addictive.strategy.artofwar	Art of War: Legions
com.adguard.AdguardPro	AdGuard Pro — adblock&privacy
com.adhoclabs.burner	Burner: Text + Call + Message
com.adidas.app	adidas
com.adidas.confirmed.app	adidas CONFIRMED
com.adobe.Adobe-Reader	Adobe Acrobat Reader PDF Maker
com.adobe.FillAndSign	Adobe Fill & Sign－Form Filler
com.adobe.PSMobile	Photoshop Express Photo Editor
com.adobe.lrmobilephone	Adobe Lightroom Photo Editor
com.adobe.post	Adobe Spark Post: Design Maker
com.adobe.scan.ios	Adobe Scan: Mobile PDF Scanner
com.adp.adpmobile	ADP Mobile Solutions
com.adp.wiselymobile	myWisely: Financial Wellness
com.adrise.tubitv	Tubi - Watch Movies & TV Shows
com.advasoft.touchretouch	TouchRetouch
com.ae.ae	AE + Aerie
com.aerfish.Universes	Universe Splitter
com.aeroappstechnology.dronepilotfaatestprep	Remote Pilot FAA Test Prep
com.aerofly.aerofly-fs-2021-ios	Aerofly FS 2021
com.aetn.mobile.ios.lifetimemoviepass	Lifetime Movie Club
com.affinityapps.blk	BLK - Dating for Black singles
com.affinityapps.chispa	Chispa - Dating for Latinos
com.affinityapps.twozerofour	Upward: Christian Dating
com.affinityblue.tunable	Tunable - Music Practice Tools
com.affinityclick.hushed	Hushed - 2nd Phone Number
com.affirm.recharge	Affirm: Shop and pay over time
com.africasunrise.skinseedforminecraft	Skinseed Pro for Minecraft
com.afterhoursds.EPA608Practice	EPA 608 Practice
com.afterpay.afterpay-consumer-us	Afterpay - Buy now. Pay later.
com.aftership.AfterShip	AfterShip Package Tracker
com.agent.action	Agent Action - Spy Shooter
com.agilebits.onepassword-ios	1Password - Password Manager
com.agminstruments.drumpadmachine	Drum Pad Machine - Beat Maker
com.aiarlabs.prequel	PREQUEL: Aesthetic Editor
com.aidana.cardriving.ios	Car Parking Multiplayer
com.aidis.lastcloudiaen	LAST CLOUDIA
com.aim.racing	Extreme Car Driving Simulator
com.aiowireless.myaio	myCricket App
com.airbnb.app	Airbnb
com.airgoat.goat.ios	GOAT – Sneakers & Apparel
com.airpods.finder	AirPod Tracker ‎
com.airydress.ios	Airycloth - Women's Fashion
com.aisense.otter	Otter: Transcribe Voice Notes
com.aitechnow.voicechanger	VoiceFX - Funny Voice Changer
com.akai.impcpro2iphone	iMPC Pro 2 for iPhone
com.akaipro.impciphone	iMPC for iPhone
com.akiliandme.alphabetEng	Akili's Alphabet
com.akrilooo.starlitvpn	StarlitVPN
com.aksonov.PS	Positive Singles: Herpes Date
com.akvelon.MheowTalk	MeowTalk Cat Translator
com.al.realdrive	Real Drive 3D
com.aladinfun.islandking.iOS	Island King
com.aladinfun.piggytravel.iOS	Piggy GO - Clash of Coin
com.alarmclockcompany.alarmclockhd	Alarm Clock HD - Pro
com.albert.Albert	Albert: Mobile Banking
com.aleksirantonen.clayhuntpro	Clay Hunt PRO
com.alexanderben.RadioIn	TuneIn Pro - Radio & Sports
com.algebramathsolver.mathapp	Algebra Math Solver
com.algoriddim.djay-iphone-free	djay - DJ App & AI Mixer
com.alhogames.minigames	Mini Watch Games 24-in-1
com.alibaba.iAliexpress	AliExpress Shopping App
com.alibaba.sourcing	Alibaba.com B2B Trade App
com.alien.shooter.galaxy.attack	Galaxy Attack: Alien Shooter
com.alightcreative.motion	Alight Motion
com.alldreamsdigital.home-outside-design	HOME OUTSIDE®
com.alloy.texting	Second Texting Number
com.allsecurevpn.evolvedigital	All Secure VPN & WiFi Proxy
com.allstate.dev.allstate	Allstate® Mobile
com.allstays.camprv	Camp & RV - Tents to RV Parks
com.allstays.onpwalmart	Walmart Overnight Parking
com.alltrails.AllTrails	AllTrails: Hike, Bike & Run
com.almasdaumov.asl-basics	ASL Basics
com.alpha.mpsen.ios	One-Punch Man:Road to Hero 2.0
com.alphapotato.pawnshopmaster	Pawn Shop Master
com.alphapotato.prankster	Prank Master 3D!
com.altercon.Kidgy	Find my Friends & Family Phone
com.am.rush	My Daily Life
com.amanitadesign.botanicula	Botanicula
com.amanitadesign.chuchel.ios	CHUCHEL
com.amanotes.bh	Tiles Hop - EDM Rush
com.amanotes.magictiles	Magic Tiles 3: Piano Game
com.amanotes.pamadancingroad	Dancing Road: Color Ball Run!
com.amapps.simple	Simple: Fasting & Meal Tracker
com.amaze.game	AMAZE!!!
com.amazon.Amazon	Amazon Shopping
com.amazon.AmazonSeller	Amazon Seller
com.amazon.CloudDrivePhotos	Amazon Photos
com.amazon.Lassen	Amazon Kindle
com.amazon.aiv.AIVApp	Amazon Prime Video
com.amazon.echo	Amazon Alexa
com.amazon.firetv.remote	Amazon Fire TV
com.amazon.freetime.FreeTime	Amazon Kids+
com.amazon.mp3.AmazonCloudPlayer	Amazon Music: Songs & Podcasts
com.amelosinteractive.snake	Snake.io - Fun Online Slither
com.americanexpress.amexservice	Amex
com.americasbestpics	ABPV America’s best pics&vids
com.amour.chicme	Chic Me - Best Shopping Deals
com.amp.ios	AmpMe - Speaker Volume Booster
com.amrita.producer	Producer: Choose your Star
com.amzero.ios	Mail App for Gmail
com.anadeem.homescreenspaces	Clear Spaces
com.ancestry.Tree-To-Go	Ancestry: Your family story
com.ancestry.dna	AncestryDNA
com.anchorfree.hss	HotspotShield VPN & Wifi Proxy
com.andreasilliger.tinywings	Tiny Wings
com.andrewkasper.labelpics	Label Pics
com.andyrdh.boardreview	AndyRDH Board Review for NBDHE
com.andyzaharia.WC	Workout Calendar - Motivation
com.angrymobgames.muffinknight	Muffin Knight
com.animatedknots.knots	Animated Knots by Grog
com.anime.tracker	9ANIME
com.aniplex.fategrandorder.en	Fate/Grand Order (English)
com.annapurnainteractive.DonutCounty	Donut County
com.annapurnainteractive.Flower	Flower
com.annapurnainteractive.Gorogoa	Gorogoa
com.anonymousai.Babble	CopyCat: Viral Videos
com.answer.light	Soulight-Online Psychic Advice
com.antares.AutoTune	Auto-Tune Mobile
com.aofl.adventureacademy	Adventure Academy
com.aol.mobile.aolclient	AOL: News Email Weather Video
com.apalonapps.alarmclock	Alarm Clock for Me
com.apalonapps.cameracalculator	SnapCalc - Math Problem Solver
com.apalonapps.livewallpapersfree	Live Wallpapers for Me
com.apalonapps.pdffree	Scan Hero: PDF Scanner App
com.apalonapps.planesfree	Planes Live - Flight Tracker
com.apalonapps.plants	Blossom - Plant Identification
com.apalonapps.radarfree	NOAA Weather Radar Live: Clime
com.apalonapps.wlf	Weather Live°
com.apartments.apartmentsapplication	Apartments.com Rental Finder
com.aplicativoslegais.Beber-Agua-Free	Drink Water ∙ Daily Reminder
com.app.reportspro	Reports Pro for Instagram
com.app.rondevo	Rondevo - Dating & Chat App
com.app.scanox	Scan Cloud
com.app.watch	Watch Faces Gallery App
com.app.watch.faces	Watch Faces Dynamic & Live
com.app77.ios.pwsafe2	pwSafe 2 - Password Safe
com.appatakkars.lumy	Lumy
com.appcraft.numberama	Numberzilla: Number Math Games
com.appdaddytech.tacticalnav	Tactical NAV
com.appdancer.eyeArt	Eye Art: Perfect Makeup Artist
com.appfolio.resident-portal	Online Portal by AppFolio
com.appicfun.translatorfree	Speak & Translate - Translator
com.apple.iMovie	iMovie
com.apple.mobilegarageband	GarageBand
com.apple.store.Jolly	Apple Store
com.appmosaic.CameraWatch	Camera Remote Watch
com.appostrophe.textart	Text Art: Poster & Quote Maker
com.apprope.a106	Word Mansion - Words & Design
com.approver.passwordmanager	Password Manager - Lock Apps
com.apps.iamnotified	iAmNotified - Anti Spy System
com.apps.planogram	PLANOLY: Plan, Schedule, Post
com.appsavers.asltranslator	ASL Translator
com.appsci.sleep	Avrora - Sleep Booster
com.appspot.scruffapp	SCRUFF - Gay Dating & Chat
com.appsverse.burnertext	Text Vault - Texting Phone App
com.appsverse.phoner	Phoner: Text+Call Phone Number
com.appynation.wbpc	Picture Cross
com.aptitude-test.com.mechanical	Mechanical Test Trainer
com.aqupepgames.pepe	Looney Tunes™ World of Mayhem
com.arcadian.ring	Ringtones for iPhone: Infinity
com.archimedesworkshop.Oilfield-Cal	Oilfield Calendar
com.archiver.ZArchive	Zarchiver
com.argosy.vb.superatlas	Human Anatomy Atlas 2021
com.arjunaweb.beforeAfterProSlideriPhone	Before and After Pro Slider
com.armorgames.CrushTheCastle	Crush the Castle
com.armorgames.flight	Flight!
com.armorgames.infectonator3	Infectonator 3: Apocalypse
com.armorgames.sushicat.phone	Sushi Cat
com.arobas-music.iGP	Guitar Pro
com.artifexmundi.unsolved	Unsolved: Hidden Mystery Games
com.asa2fly.AMT	Prepware Aviation Maintenance
com.asa2fly.FARAIM	FAR/AIM
com.asa2fly.Prepware	Prepware Private Pilot
com.asanayoga.asanarebel	Asana Rebel: Get in Shape
com.ascendlearning.uglys	Ugly's Electrical References
com.ascendo.datavault	Password Manager Data Vault
com.asherlporetz.SpyCameraDetector	Spy hidden camera Detector
com.asiainnovations.taiwnan	Uplive-Live Stream,Video Chat
com.asmodee-digital.carcassonne	Carcassonne – Tiles & Tactics
com.asmodee-digital.terraformingmars	Terraforming Mars
com.asos.asos	ASOS
com.aspiro.TIDAL	TIDAL Music
com.aspyr.jadeempire.ios	Jade Empire™: Special Edition
com.aspyr.kotor.ios	Star Wars™: KOTOR
com.aspyr.kotor2.ios	Star Wars™: KOTOR II
com.asqx.iphoneproduction	Alaska Airlines
com.astech.FORScan-Lite	FORScan Lite - for Ford, Mazda
com.asterisk.sticker	Sticker Now - Emoji & Memes
com.astragon.cs2016	Construction Simulator 2
com.astragon.cs3	Construction Simulator 3
com.astragon.trucksimtwo	Truck Simulation 19
com.astrograph.TimePassagesiPhone	TimePassages Pro
com.atadore.AppleWatchAlexa	Voice in a Can
com.atari.mobile.rctclassic	RollerCoaster Tycoon® Classic
com.atastypixel.loopy-hd	Loopy HD: Looper
com.atebits.Tweetie2	Twitter
com.atenuniversity	Aten University
com.atomrpg	ATOM RPG
com.att.FamilyMap	AT&T Secure Family™
com.att.attcallprotect	AT&T Call Protect
com.att.osd.myWireless	myAT&T
com.att.shm	Smart Home Manager
com.atypicalgames.RiseOfGlory	Sky Gamblers Rise Of Glory
com.atypicalgames.sgsr2	Sky Gamblers - Storm Raiders 2
com.au.dance.en	Sweet Dance
com.audible.iphone	Audible audiobooks & podcasts
com.audio.yoho.ios	YoHo - Group Voice Chat
com.audiomack.iphone	Audiomack - Download New Music
com.ausappstudio.brainbuddy	Brainbuddy: Quit Porn Forever
com.authy	Twilio Authy
com.autumn.skullgirls	Skullgirls: Fighting RPG
com.auxbrain.egginc	Egg, Inc.
com.avast.ios.security	Avast Security & Privacy
com.avcr.Funimate	Funimate Video Editor & Maker
com.avecreation.drivingzone2	Driving Zone 2
com.avidionmedia.iGun2	iGun Pro 2
com.avidlifemedia.ashleymadison	ASHLEY MADISON: Life Is Short.
com.aw.tappyWatchBirdFree	Bird Watch Game Free
com.aws.weatherbug.elite	WeatherBug Elite
com.aws.weatherbug.pro	WeatherBug – Weather Forecast
com.axiemsystems.photoeditor	Photo Editor+
com.axiemsystems.photoeditorminus	Photo Editor-
com.axis.drawingdesklite	Drawing Desk: Draw & Paint Art
com.axs.AXSMobile	AXS Tickets
com.azurgames.stackball	Stack Ball 3D
com.b2p.stackydash	Stacky Dash
com.babbel.babbelMulti	Babbel - Language Learning
com.babil.panzer	نداء الحرب 3 | حربية عالمية
com.baby2bodylimited.baby2body	Baby2Body: Pregnancy Wellness
com.babycenter.mypregnancytoday	Pregnancy Tracker - BabyCenter
com.babyeducationtoys.fashionstyle	Super Stylist
com.babyscope	BabyScope Hear Baby Heartbeat
com.babyshusher.babyshusher	Baby Shusher: Calm Sleep Sound
com.backflipstudios.dragongame	DragonVale
com.backflipstudios.transformersearthwars	Transformers: Earth Wars
com.backstage.casting	Backstage Casting
com.badlogicgames.ghh	Gloomhaven Helper
com.badoo.Badoo	Badoo — Dating. Chats. Friends
com.badoo.BadooSPP	Badoo Premium
com.bagatrix.mathway	Mathway: Math Problem Solver
com.bagelcode.slots1	Club Vegas Slots: Casino Games
com.baidu.PhotoWonder	Photo Wonder
com.baidujp.SimejiIntl	Facemoji Keyboard: Fonts&Emoji
com.ballytechnologies.f88	88 Fortunes Slots Casino Games
com.ballytechnologies.quickhitslots	Quick Hit Slots - Casino Games
com.bandlab.bandlab.iphone	BandLab – Music Making Studio
com.bankofamerica.BofA	Bank of America Mobile Banking
com.bankofamerica.prepaid	BofA Prepaid Mobile
com.banuba.aicamera	Easysnap: Retouch Photo Editor
com.banzaiabs.BrainWave	Brain Wave™ 35 Binaural Series
com.barges.purpleocean	Purple Ocean Psychic Readings
com.barnstormgames.mensamobiletestusuk	American Mensa Brain Test
com.baronapp.cameo	Cameo - Personal celeb videos
com.barsstudios.swordplay2	Sword Play! Ninja Slice Runner
com.basenji.mood	Breeze: mood tracker, diar‪y
com.basevelocity.RadarScope	RadarScope
com.bathandbodyworks.app	My Bath & Body Works
com.batoulapps.Guidance	Guidance: Islamic Prayer Times
com.battlecreek.nolimit2	No Limit Drag Racing 2
com.battlecreek.offroadoutlaws	Offroad Outlaws
com.bazilsoft.mybabyheart	Baby Beat™ Heartbeat Monitor
com.bbumgames.spadesroyale	Spades Royale: Play Card Games
com.beHappy.Productive	Productive - Habit Tracker
com.beachbody.bod	Beachbody® On Demand
com.beachbumgammon	Backgammon - Lord of the Board
com.beanstargames.dingbats	Dingbats - Word Games & Trivia
com.bearbit.srw2	Smashy Road: Wanted 2
com.beardice	Bear Dice
com.beastmaker.beastmaker	Beastmaker Training App
com.beenverified.BackgroundChecker	BeenVerified Search
com.befunky.visionn	Visionn
com.beingame.zc.zombie.shelter.survival	Zero City: Shelter Survival
com.beliefengine.handyapp	Handy Art Reference Tool
com.belk.ios.handset	Belk
com.belka-games.solitaire	Solitaire Cruise Tripeaks Card
com.belkatechnologies.clockmaker	Clockmaker: Match Three Games
com.belkatechnologies.fe	Funky Bay – Farm & Adventure
com.belleautechnologies.promptsmart	PromptSmart Pro - Teleprompter
com.bellus3d.facecameraapp	Bellus3D FaceApp
com.beltola.superimpose	Superimpose
com.ben.VXCam	Death Lens
com.bencallis.WatchTo5K	Watch to 5K - Couch to 5km Run
com.benjamind.failrun	Fail Run
com.bennettracingsimulations.dirttrackin	Dirt Trackin
com.bennettracingsimulations.dirttrackin2	Dirt Trackin 2
com.bereainternacional.himnario	Himnario LLDM
com.bermuda	Bermuda-Random Live Video Chat
com.best-app-dev.Circle-Crop	Circle Crop
com.bestbuy.buyphone	Best Buy
com.bethsoft.DOOMII	DOOM II
com.bethsoft.falloutshelter	Fallout Shelter
com.betterme.bettermen	BetterMe: Workouts for Men
com.betterme.meditation	BetterMe: Meditation & Sleep
com.betternet	Best VPN Proxy Betternet
com.bfg.idioms	English language: Learn & Play
com.bgg.jump	Project Makeover
com.bgios.second.overseas	Brain Go 2: Test your brain
com.bhn.careapp	My Spectrum
com.bhvr.deadbydaylight	Dead by Daylight Mobile
com.bickster.FindMyAppleWatch	Find My Device - Bluetooth BLE
com.big.summerwheelie	Summer Wheelie
com.bigbeardaudio.echovox	EchoVox
com.bigbluebubble.My-Singing-Monsters	My Singing Monsters
com.bigbluebubble.msmcomposer	My Singing Monsters Composer
com.bigborisstudios.iosghostcompro	Ghostcom Communicator Pro
com.bigduckgames.flow	Flow Free
com.bigfishgames.bfcasinouniversalfreemium	Big Fish Casino: Big Win Slots
com.bigfishgames.cookingempireuniversalf2p	Cooking Craze: Restaurant Game
com.bigfishgames.fairwaysolitaireuniversalf2p	Fairway Solitaire - Card Game
com.bigfishgames.jackpotcityslotsf2pios	Jackpot Magic Slots™ & Casino
com.bigfishgames.mergetalesios	EverMerge - Merge and Match!
com.bigfishgames.worldsagaaapluniversalF2P	Gummy Drop! Match 3 Puzzles
com.bigpantsgroup.app.NotanIzer	NotanIzer
com.bigrunstudios.blackoutblitz	Blackout Bingo
com.bigwinepot.nwdn.international	Remini - AI Photo Enhancer
com.binaryspacegames.zombie-outbreak-simulator	Zombie Outbreak Simulator Pro
com.binatebitsinfotech.tattoostencil	Tattoo Stencil
com.bingo.scape.ios.free	Bingo Journey！Real Bingo Games
com.bingo.tour.party.crazy.free.ios.avidly	Bingo Party - Slots Bingo Game
com.bingo.wild.free.ios	Bingo Wild – Live BINGO Games
com.bitcoin.mwallet	Bitcoin Wallet: buy BTC & BCH
com.bitcount.cleartune	Cleartune
com.bitmango.ap.blockhexapuzzle	Block! Hexa Puzzle™
com.bitmango.ap.blocktrianglepuzzletangram	Block! Triangle puzzle:Tangram
com.bitmango.ap.bubblepop	Bubble Pop! Puzzle Game Legend
com.bitmango.ap.jewelsmagicmysterymatch3	Jewels Magic: Mystery Match3
com.bitmango.ap.wordcookies	Word Cookies!®
com.bitmart.exchange	BitMart - Crypto Exchange
com.bitrhymes.bingoiphone	Bingo Bash: Live Bingo Games
com.bitstrips.imoji	Bitmoji
com.bitworksdesign.bleeptestsolo	Bleep Test Solo
com.bk.pop-us-mobile	Popeyes®
com.blazinrewards	Buffalo Wild Wings
com.blinggame.mtree.io	Money Garden
com.blinkslabs.Blinkist	Blinkist: 15min Book Insights
com.blizzard.wtcg.hearthstone	Hearthstone
com.blockfolio.blockfolio	Blockfolio: Buy Bitcoin Now
com.blocoware.speedometer	Speedometer 55 Pro. GPS kit.
com.bloomberg.Bloomberg	Bloomberg: Business News
com.bloomnu.slay	SLAY by Mari
com.blowfire.wildclassic	Wild Classic Slots Casino Game
com.bluebraingames.thehouseofdavinci	The House of Da Vinci
com.bluebraingames.thehouseofdavinci2	The House of Da Vinci 2
com.blued.international	Blued: Meet & date cute guys
com.blueflamingo.herolab	Heroes Inc!
com.bluelight.unitsplus	Units Plus Converter
com.blushmark.ios	Blush Mark: Women's Clothing
com.bodybuilding.rise	BodyFit Fitness Training Coach
com.boltcreative.journeytouranus	Pocket God: Journey To Uranus
com.boltcreative.pocketgod	Pocket God
com.boltrend.disgaea.en	DISGAEA RPG
com.bonsaisoft.flagday	Flag Day - US Flag Calendar
com.bonusxp.fate	Stranger Things 3: The Game
com.boo.fonts	Fonts keyboard-font and symbol
com.boohoo.app	boohoo – Clothing Shop
com.boohoo.boohooMAN	boohooMAN – Men’s fashion
com.booking.BookingApp	Booking.com: Hotels & Travel
com.bookmobile.iphone.lolg	The Language of Letting Go
com.boombitgames.DrivingSchoolParking	Car Driving School Simulator
com.boomerang.boom	Boomerang - Cartoons & Movies
com.bossastudios.iambread	I am Bread
com.bossastudios.ss13touch	Surgeon Simulator
com.bostonbanana.VideoToLive	VideoToLive
com.boundlessdrop.jawaker	Jawaker: Card Games & Friends
com.bowengames.farmingusa	Farming USA
com.bowengames.farmingusa2	Farming USA 2
com.bowengames.pullingusa2	Pulling USA 2
com.bpit.ms	Spy Block: online protection
com.braindom2riddle	Braindom 2: Brain Teaser Games
com.brainfevermedia.AlienSky	Alien Sky - Space Camera
com.brainly.us	Brainly – Homework Help App
com.brainssoftware.obliquestrategies	Oblique Strategies SE
com.braintoss.braintoss	Braintoss
com.brave.ios.browser	Brave Private Web Browser VPN
com.brewmium.hogscan	HogScan
com.bricksball.civil.crusher	Bricks Ball Crusher
com.brijit.auxsheelia.Wallax	Wallax
com.btang.thermometer	Femometer Period Tracker
com.btgs.scannerhd	Tiny Scanner Plus
com.btgs.scannerhdlite	Scanner App: Scan PDF Document
com.btgs.tinyfax	Fax from iPhone - Tiny Fax
com.budgestudios.BarbieDreamhouse	Barbie Dreamhouse Adventures
com.buffalo-studios.newflashbingo	Bingo Blitz™ - BINGO games
com.bufumufu.PRODUCTNAMErfc1034identifier	Apnea Trainer
com.buildcalc.BuildCalc	BuildCalc
com.bulletjournal.bujo	Bullet Journal Companion
com.buoy76.huntpredictor	HuntWise: A Better Hunting App
com.burak.freefall	Bricky Fall
com.burbn.instagram	Instagram
com.burbn.layouts	Layout from Instagram
com.bushiroad.en.bangdreamgbp	BanG Dream! Girls Band Party!
com.bushiroad.en.vgzero	Vanguard ZERO
com.busuu.english.app	Busuu: Language Learning App
com.bwf.BWF	DOWN 18+ Fantasy: Wink 2 Match
com.bwm.coaster	Hyper Roller Coaster
com.bytro.supremacy1914	Supremacy 1914
com.calculate84	Calculate84
com.calculated.ashley3415	Qualifier Plus IIIx/fx
com.calculated.iticalc4186	ITI Calc
com.calculated.josephine4095	Pipe Trades Pro
com.calculated.laurene	Construction Master Pro
com.calculated.laurene4050	Construction Master 5
com.calculated.laurene4225	ConcreteCalc Pro
com.callaway.endlessalphabet	Endless Alphabet
com.caller.screen.show	iShow Screen
com.calm.calmapp	Calm
com.calottery.calottery	CA Lottery Official App
com.cam001.selfie	Sweet Selfie: Photo Editor&Cam
com.camelgames.aoz	Age of Z Origins
com.camelgames.galaxy	Infinite Galaxy
com.camelgames.superking	War and Order
com.cameogames.diymakeup	DIY Makeup
com.camerasideas.InstaShot	InShot - Video Editor
com.cameronchow.Strong	Strong Workout Tracker Gym Log
com.candyrufusgames.survivalcraft	Survivalcraft
com.candyrufusgames.survivalcraft2	Survivalcraft 2
com.canva.canvaeditor	Canva: Graphic Design & Video
com.capitalone.credittracker2	Capital One CreditWise
com.capitalone.enterprisemobilebanking	Capital One Mobile
com.captain-games.desertgolf	Desert Golfing
com.capybaragames.swordandsworcery	Superbrothers: Sword & Sworcery EP
com.cardify.tinder	Tinder - Dating New People
com.cardinalblue.PicCollage	PicCollage: Fun Layout Editor
com.care.iphone	Care.com: Hire Babysitters
com.care.provider	Care.com Caregiver: Find Jobs
com.carfax.ConsumerApp	CARFAX Find Used Cars for Sale
com.cargurus.v1	CarGurus: Used & New Cars
com.carlosunseri.collegelacrosse2014	College Lacrosse 2014
com.carlosunseri.collegelacrosse2018	College Lacrosse 2019
com.carmax.carmax	CarMax: Used Cars for Sale
com.carolanitz.voice-pitch-analyzer	Voice Pitch Analyzer
com.carolgames.moemoegirls	Girls X Battle 2
com.carvana.copilot	Carvana: Buy Used Cars Online
com.carx-tech.carxdr2	CarX Drift Racing 2
com.casetagram.CasetagramApp	CASETiFY
com.cassette.aquapark	aquapark.io
com.casual.impostor.smasher	Smasher Around Us: Fun io game
com.casual.stairwaytoheaven	Stairway to Heaven !
com.casualpunch.lipart	Lip Art 3D
com.catalina.extracleaner	Extra Clean: Device Optimizer
com.cateater.funapps.stopmotionstudiopro	Stop Motion Studio Pro
com.catforce.decidenow	Decide Now! — Random Wheel
com.cbsbrand.video	CBS
com.cbsvideo.app	Paramount+
com.cbvero.qidif	OP:Straw Hat Chase
com.ccmc.flashcards	CCM Glossary App
com.cct.hingeit	Fit'em All
com.cdprojektred.gwentthronebreaker	Thronebreaker
com.cengage.cosmo	Milady Cosmetology Exam Review
com.cepherapp	Cepher
com.cg.moneybuster	Money Buster!
com.chameleon.amsw	Army Men Strike: Toy Soldiers
com.champssports.champssports	Champs Sports: Kicks & Apparel
com.changecollective.tenpercenthappier	Ten Percent Happier Meditation
com.chaninicholas.chaniapp	CHANI
com.chase	Chase Mobile®: Bank & Invest
com.chatjoy.dating	Chatjoy-Live Video Chat App
com.chegg.mobile.consumer	Chegg Study - Homework Help
com.chemicalwedding.ArtemisPro	Artemis Pro
com.chepri.mrbeastburger	MrBeast Burger
com.cherru.pro.video.chat	CherrU: Online Video Chat
com.cherryLive.cherry	CherryLive - Live Video & Chat
com.chess.iphone	Chess - Play & Learn
com.chewy.chewy	Chewy - Where Pet Lovers Shop
com.chillfleet.buddy	Kick the Buddy
com.chillseekers.deadwave	DeadWave
com.chillseekers.signal	Signal Spirit Communication
com.chipotle.Chipotle	Chipotle
com.chobolabs.thuglife	Thug Life Game
com.chopraglobal.chopra	Chopra Meditation & Well-Being
com.chris.ios.mydayspro	MyDays X Pro
com.christapps.fakebankaccount.free	Fake Bank Pro
com.christapps.fakebankaccount.pro	Fake Bank Account Pro
com.chromanoir.spectre	Spectre Camera
com.chrononumericlabs.us-debt-clock-real-time	US Debt Clock .org
com.chucklefish.stardewvalley	Stardew Valley
com.cihan.crashmasterrr	Crash Master 3D
com.cinamongames.maybegv	maybe: Interactive Stories
com.cinegenix.filmic.pro	FiLMiC Pro－Video Camera
com.cinna.collectcubes	Collect Cubes
com.cinnacorp.Trak4	Tracking App for Trak-4 GPS
com.circular.pixels	Pixelcut: AI Graphic Designer
com.citigroup.citimobile	Citi Mobile®
com.cjfafafa.trojan.ios	Huge Win Slots！Casino Games
com.clafou.print	Print to Size
com.clapfootgames.tankhero	Tank Hero
com.clarusvictoria.preciv.bronzehd	Bronze Age
com.classicalconversations.Cycle1Tutorials	Foundations Memory Work C1
com.clearchannel.iheartradio	iHeart: Radio, Music, Podcasts
com.clearme.Clear	CLEAR - Fast, Touchless Access
com.cleverturtle.brickbuilder	Brick Builder!
com.click2mobile.collagegrameFree	Collage Maker ◇
com.clickteam.freddyfazbearspizzeriasimulator	FNaF 6: Pizzeria Simulator
com.clickteam.onaf1	One Night at Flumpty's
com.clickteam.onaf2	One Night at Flumpty's 2
com.clickteam.ultimatecustomnight	Ultimate Custom Night
com.cliffweitzman.speechifyMobile2	Speechify - Audio Text Reader
com.clipwiregames.bingostory	Bingo Story Live Bingo Games
com.cloudmosa.puffin	Puffin Browser Pro
com.clowngames.boas.io.snake.vs.city	Boas.io Snake vs City
com.cmcm.live	LiveMe – Live Stream & Go Live
com.cmilburndesign.widgif	Widgif
com.cmplay.bricksballs	Bricks n Balls
com.cobbysoft.hauntedvision	Black Light Vision
com.cocologics.ProCamera	ProCamera.
com.codebrewgames.pocketcity	Pocket City
com.codemasters.f12016	F1 2016
com.codeorgana.brushstroke	Brushstroke
com.codeorgana.tooncamera	ToonCamera
com.codexivetechlimited.lifeseeker	Life Seeker-Tests&Face Effects
com.codigames.idle.prison.empire.manager.tycoon	Prison Empire Tycoon－Idle Game
com.codigames.university.empire.idle.tycoon	University Empire Tycoon－Idle
com.coffeemeetsbagel.mobile.ios	Coffee Meets Bagel Dating App
com.coffeestainstudios.goatmmo	Goat Simulator MMO Simulator
com.coffeestainstudios.goatsimulator	Goat Simulator
com.coffeestainstudios.payday	Goat Simulator PAYDAY
com.coffeestainstudios.wasteofspace	Goat Simulator Waste of Space
com.cogitap.SlowShutter	Slow Shutter Cam
com.coinbase.pro	Coinbase Pro
com.coinmarketcap.CoinMarketCap	CoinMarketCap: Crypto Prices
com.collage.belka	Photo Collage - Collageable
com.colobolo.chainball	Chain Cube: 2048 3D Merge Game
com.colorCall.MC	ColorMe Call & Ringtones
com.colorhole.game	Color Hole 3D
com.coloring.color.number.ios	Happy Color™ – Coloring Games
com.colorswitch.switch2	Color Switch
com.colorup.game	Color Bump 3D
com.com2us.homerunbattle2.normal.paidfull.apple.global.ios.universal	HB2 PLUS
com.com2us.lostcenturia.ios.apple.global.normal	Summoners War: Lost Centuria
com.com2us.ninepb3d.normal.freefull.apple.global.ios.universal	MLB 9 Innings 21
com.com2us.smon.normal.freefull.apple.kr.ios.universal	Summoners War
com.comcast.cim.myaccount	Xfinity My Account
com.comcast.cim.x2	Xfinity Stream
com.comcast.xwifi	Xfinity WiFi Hotspots
com.comcsoft.izippro	iZip Pro -Zip Unzip Unrar Tool
com.commsource.BeautyPlus	BeautyPlus-Snap,Retouch,Filter
com.companyofficer5.flashfire	Flash Fire Company Officer 5th Edition
com.comunix.pokerface	Poker Face - Meet & Play Live
com.concretesoftware.golf	PGA TOUR Golf Shootout
com.conduent.EZPassNJ	NJ E-ZPass
com.contentf.blogger	Blogg for Blogger
com.contextlogic.Wish	Wish - Shopping Made Fun
com.contextoptional.OpenTable	OpenTable
com.conversdigital.mconnectplayer	mconnect Player
com.cookiejardevelopment.IncidentResponsePocketGuide	Mobile IRPG
com.cooking.bingo.delicious	Bingo Frenzy -Live Bingo Games
com.cookingcity.chefgame.feverkitchen.free	Cooking City - Restaurant Game
com.coomeet.free	CooMeet
com.copilotgames.FlipperDunk	Flipper Dunk
com.coresignals.mapmeasure.ios	Planimeter — Measure Land Area
com.corrodinggames.rustedwarfare.ios	Rusted Warfare - RTS
com.costarastrology.costar-mobile	Co–Star Personalized Astrology
com.costco.costco	Costco
com.cottongame.raintown	Rain City
com.coudriet.weatherradio	NOAA Weather Radio
com.coursehero.Course-Hero	Course Hero | Homework Help
com.courtneycircle.Radiant	Zero: Fasting & Health Tracker
com.coverme.covermeAdhoc	CoverMe Private Text & Call
com.cqgaming.idlemafia	Idle Mafia
com.crazydevjj.HashiriyaDrifteriOS	Hashiriya Drifter #1 Racing
com.crazylabs.acrylicnails	Acrylic Nails!
com.crazylabs.ladybug	Miraculous Ladybug & Cat Noir
com.crazymaplestudio.aurora	Kiss - Read & Write Romance
com.crazymaplestudio.spotlight	Spotlight: Choose Your Romance
com.creativemobile.nno	Nitro Nation Drag & Drift
com.creditkarma.mobile	Credit Karma
com.creditonebank.mobile	Credit One Bank Mobile
com.creditsesame.mobile.ios.finance	Credit Sesame
com.cricut.explore	Cricut Design Space
com.cristiano.dmvgeniusfree	DMV Permit Practice Test Genie
com.crossfiredesigns.iConnectHue	iConnectHue for Philips Hue
com.crossforward.WidgetSmith	Widgetsmith
com.crossforward.pedometer	Pedometer++
com.crossutility.quantumult	Quantumult
com.crossutility.quantumult-x	Quantumult X
com.crowdedroad.Sign	Fill PDF Editor, Signature app
com.crowdedroad.ifaxpro	iFax: Fax from iPhone ad free
com.crowdstar.covet	Covet Fashion: Model Makeover
com.crowdstar.covetHome	Design Home: House Renovation
com.crunchyroll.iphone	Crunchyroll
com.crunchyroll.princessconnectredive	Princess Connect! Re: Dive
com.crushapps.Paperless	Paperless: Lists + Checklists
com.csj.ling	Ringtones Maker - the ring app
com.csre.loanorigination	Loan Origination Flashcards
com.csre.national	Real Estate Flashcards
com.csre.texas	TX Real Estate Exam Flashcards
com.culturedcode.ThingsiPhone	Things 3
com.cumbemg.davinci	Da Vinci Eye: AR Art Projector
com.cupid.mduk	Mature Dating - Local Singles
com.cupid.uniformdating	Uniform Dating: Meet Your Hero
com.cupshe.cupsheapp	Cupshe - Swimsuit Fashion Shop
com.current.currentapp	Current - Bank for Modern Life
com.cuteu.dating	CuteU-Live Video Chat App
com.cvs.cvspharmacy	CVS Pharmacy
com.cw.fullepisodes.ios	The CW
com.cyanworlds.Myst	Myst
com.cyanworlds.Riven1	Riven (iPhone version)
com.cyberghostsrl.cyberghostvpn	VPN by CyberGhost - WiFi Proxy
com.cyberlink.youcammakeup	YouCam Makeup: Selfie Editor
com.cyberlink.youperfect	YouCam Perfect: Photo Editor
com.cybernate.physfighter	Slapstick Fighter: Fight Games
com.cyberprodigy.ConduitBender	Conduit Bender Elite - Calc
com.cyberstep.toreba1	Claw machine Toreba
com.czzhao.binance	Binance: Buy Bitcoin Securely
com.d3p.yorkMPQ	MARVEL Puzzle Quest: Hero RPG
com.dailybloom.Bloom	Bloom: CBT Therapy & Self-Care
com.dairyqueen.ios.loyaltyapp.production	Dairy Queen®
com.dancing.smash.hop.game.tiles.circles.beat.paino	Smash Colors 3D 2021
com.danigil.alarm	Music Alarm Clock for Spotify+
com.dash.rhythm.dancing.smash.hop.game.tiles.circles.beat.paino	Beat Shooter:Rhythm shooting
com.dashlane.dashlanephonefinal	Dashlane – Password Manager
com.dating.KinkO	Kinkoo: Kinky, Fet BDSM Dating
com.dattch.dattch	HER:Lesbians LGBTQ Dating App
com.dave.logomaker	Logo Maker - A Design Creator!
com.davidnorcott.fbi	FBI Workout with Stew Smith
com.daysofwonder.TicketToRideiPad	Ticket to Ride - Train Game
com.dazn.theApp	DAZN: Live Sports Streaming
com.dazz.hoop	Hoop - Make new friends
com.dcdc.hwsj	Game of Sultans
com.ddpyoga.ddpyoga	DDP Yoga Fitness & Motivation
com.dearu.bubble.jyp	bubble for JYPnation
com.debotoshdey.SquareSize	No Crop – Video & Pictures Fit
com.debotoshdey.slideshow	SlideShow Maker with Music Fx
com.deezer.Deezer	Deezer: Music & Podcast Player
com.delta.iphone.ver1	Fly Delta
com.demin.emojipuzzle	Emoji Puzzle!
com.dena.12026418	Pokémon Masters EX
com.denizkocoglu.faby	Faby Bird : The Flappy Adventure
com.desertrescue.DRR-Rescue	DRR Rescue
com.designapp.customwidget	Widget+ Custom HomeScreen
com.deuscraft.TurboTeam	Grand Hotel Mania
com.dev.games.phraseparty.main	Phrase Party!
com.devdop.titans3D	Titans 3D
com.devolver.downwell	Downwell
com.devolver.gris	GRIS
com.devolver.reigns	Reigns
com.devolver.reignsGoT	Reigns: Game of Thrones
com.devsisters.ck	Cookie Run: Kingdom
com.devsisters.gb	Cookie Run: OvenBreak
com.dhgate.DHgateBuyer	DHgate-Online Wholesale Stores
com.diandian.gog	Guns of Glory: Conquer Empires
com.diandian.kingofavalon	King of Avalon: Dragon Warfare
com.diarycard.dbt	DBT Diary Card & Skills Coach
com.digby.bedbathbeyond	Bed Bath & Beyond
com.digiqallimited.smarttranslate	Smart Translate-AI Scanner
com.digiset.webrecorder	Record it! :: Screen Recorder
com.digitalattic.cpsalbertsons2018	Shop, Play, Win!® MONOPOLY
com.digitaldowsing.iOvilus	iOvilus
com.digitalgoldfish.BloonsTD4	Bloons TD 4
com.dimasjktv.vengeancerpg	Vengeance RPG
com.dipaola.airductcalc	WinFab - Sheet Metal Ductulator
com.direlight.grimvalor	Grimvalor
com.direwolfdigital.root	Root Board Game
com.dirtybit.fra	Fun Run 3 - Multiplayer Games
com.discoverfinancial.mobile	Discover Mobile
com.discovery.mobile.discoveryplus	discovery+ | Stream TV Shows
com.dishdigital.sling	Sling: Live TV, Shows & Movies
com.disney.DLR	Disneyland®
com.disney.MyDisneyExperience	My Disney Experience
com.disney.SwampyGame	Where's My Water?
com.disney.castleofillusion	Castle of Illusion
com.disney.disneyplus	Disney+
com.disney.emojimatch	Disney Emoji Blitz
com.disney.frozensaga	Disney Frozen Free Fall Game
com.disney.starwarshub	Star Wars
com.disney.stickers.thechild	Grogu™ Sticker Pack
com.disney.stickers.themandalorian	The Mandalorian Stickers
com.disney.stickers.theriseofskywalker	The Rise of Skywalker Stickers
com.distractionware.superhexagon	Super Hexagon
com.djinnworks.StickmanVolleyball	Stickman Volleyball
com.djit.bassboost	Bass Booster Volume Power Amp
com.djit.equalizerPlus-iOS	Equalizer+ HD music player
com.dmacpro91.jb4-mobile	JB4 Mobile
com.dmorneault.gpstracks	GPS Tracks
com.dn.ios.games.dtmafia	Downtown Mafia: Gang Wars RPG
com.doctor.care	Doctor Care!
com.docusign.DocuSignIt	DocuSign - Upload & Sign Docs
com.doink.DKGreenScreen	Green Screen by Do Ink
com.dollargeneral.iphone	Dollar General
com.dolldivine.fairytalehigh	Fairy Tale High
com.dominos.iphone	Domino's Pizza USA
com.domustechnica.tww	The Wonder Weeks
com.donutgames.ratonascooterxl	Rat On A Scooter XL
com.donutgames.sundaylawn	Sunday Lawn
com.donutgames.trafficrush	Traffic Rush
com.doordash.dasher	DoorDash - Driver
com.doradogames.conflictnations.ww3	Conflict of Nations: WW3
com.dorotheebrondes.bounceandcollect	Bounce and collect
com.dotemu.ddtrilogydev	Double Dragon Trilogy
com.doubledogstudios.ConstructionPro	Home Builder Pro Calcs
com.doubledogstudios.idwood	I.D. Wood
com.doubledogstudios.rangerhandbook	Army Ranger Handbook
com.doubledowninteractive.DDCasino	DoubleDown™- Casino Slots Game
com.doubledowninteractive.ftknox	Slots DoubleDown Fort Knox
com.doubledowninteractive.kiwiexperience	DoubleDown Classic Slots
com.doublespeakgames-scratchworkdev.adarkroom	A Dark Room
com.doubleugames.DoubleUCasino	DoubleU Casino: Vegas Slots
com.doukan.streetviewmap	StreetViewMap Street View Maps
com.dowjones.WSJ.ipad	The Wall Street Journal.
com.dp.hidden.objects	Hidden Objects - Photo Puzzle
com.dq.myLightMeterPro	myLightMeter PRO
com.dr1ven.eraser	PhotoRoom Studio Photo Editor
com.dragonplus.cookingfrenzy	Cooking Frenzy® Crazy Chef
com.dragonscapes.global	Dragonscapes Adventure
com.dramaton.slime	Super Slime Simulator
com.dream4today.HeartRate.Pro	Heart Rate Pro-Health  Monitor
com.dreamappstudio.dialogfree	Dialog - Translate Speech
com.dreame.reader	Dreame - Read Best Romance
com.dreamgames.royalmatch	Royal Match
com.drivewyze.Agatha	Drivewyze
com.droidhang.ad	Idle Heroes - Idle Games
com.drycactus.pb2	Poly Bridge 2
com.drycactus.polybridge	Poly Bridge
com.dsg.mobile.consumer	DICK’S Sporting Goods, Fitness
com.dts.freefireth	Garena Free Fire- World Series
com.duckduckgo.mobile.ios	DuckDuckGo Privacy Browser
com.ducky.bikehill3d	Riding Extreme 3D
com.dunkinbrands.otgo	Dunkin'
com.duolingo.DuolingoMobile	Duolingo - Language Lessons
com.duosecurity.DuoMobile	Duo Mobile
com.duoyi.shenwu3	神武4
com.dustywallet.QSeer	QSeer Coupon Reader
com.dvloper.granny	Granny
com.dxm.nopuzzle	Block Puzzle - Brain Test Game
com.ea.ios.fifamobile	FIFA Soccer
com.ea.ios.maddennfl21mobile	Madden NFL 21 Mobile Football
com.ea.ios.nbamobile	NBA LIVE Mobile Basketball
com.ea.ios.simsmobile	The Sims™ Mobile
com.ea.nbajam.inc	NBA JAM by EA SPORTS™
com.ea.nfs13.inc	Need for Speed™ Most Wanted
com.ea.nfs2014.bv	Need for Speed No Limits
com.ea.pvzfree.bv	Plants vs. Zombies™
com.ea.realracing3.inc	Real Racing 3
com.ea.simcitymobile.bv	SimCity BuildIt
com.ea.simpsonssocial.inc2	The Simpsons™: Tapped Out
com.ea.sims3deluxe.ipad.inc	The Sims™ FreePlay
com.ea.starwarscapital.bv	Star Wars™: Galaxy of Heroes
com.earthconsciousapps.landscapelightingtoolkit	Landscape Lighting Calculator
com.eastsidegames.trailerparkboys	Trailer Park Boys Greasy Money
com.easybrain.blockudoku	Blockudoku: Block Puzzle Games
com.easybrain.brain.game	Easy Game - Brain Test
com.easybrain.differences	Differences - Find & Spot them
com.easybrain.make-music	Groovepad - Music & Beat Maker
com.easybrain.nonogram	Nonogram.com - Number Puzzle
com.easybrain.puzzles	Jigsaw Puzzles - Puzzle Games
com.easybrain.solitaire	Solitaire – Classic Card Games
com.easybrain.sudoku	Sudoku.com - Sudoku Puzzle
com.easybrain.sudoku.killer	Killer Sudoku by Sudoku.com
com.easygames.resize	Re-Size-I‪t‬: Brain Teaser
com.easyvirtualchoir.evc	EasyVirtualChoir
com.ebay.iphone	eBay - Buy and sell on the go
com.eboticon.DD4L	DD4L Emojis
com.ebsolutions.josemaria	St. Josemaria
com.eclipse.vpn.service	Eclipse VPN: Online Security
com.ecomi.veve	VeVe Collectibles
com.ecourier.mobile.ecMobile	ecMobile
com.ecw.Healow	healow
com.eddie.villagegolfcart	Villages GPS
com.edjing.edjingdjturntable	edjing Mix - DJ Mixer App
com.edpuzzle.EDpuzzle	Edpuzzle
com.eharmony.singles.SinglesRelease	eharmony – the dating app
com.ei.robmaster3d	Rob Master 3D
com.eightsec.TriviaIO	Trivia.io
com.eightsec.idlearmy	Idle Army
com.elecpe.nec2017	A NEC® 2017 Quick Reference
com.elektron.mindpal	MindPal - Brain Training
com.elevateapp.elevate	Elevate - Brain Training
com.elex-tech.ClashOfKings	Clash of Kings - CoK
com.elex.nikki	Love Nikki-Dress UP Queen
com.elex.twdsaw.apple	The Walking Dead: Survivors
com.elf-audio.koala	Koala Sampler
com.ellation.vrv	VRV - Different All Together
com.ellis.itrackbites	iTrackBites: Weight Loss Diet
com.elokence.akinator	Akinator VIP
com.elokence.akinator.free	Akinator
com.emagroups.ic2	Tales of Wind
com.emeals	eMeals - Healthy Meal Plans
com.emedia.PocketAnatomyLegacy	Pocket Anatomy
com.emn8.mobilem8.native.bkrewards	BURGER KING® App
com.emoji.freemium	Emoji>
com.empower.finance	Empower: Cash Advance, Banking
com.endel.endel	Endel: Focus, Sleep, Relax
com.energetiqlimited.coolwallpaper	Cool Live Wallpapers 4K&Themes
com.engauge.Chick-fil-A	Chick-fil-A
com.enterprise.eracmobile	Enterprise Rent-A-Car
com.entropy-central.ZuluTime	Zulu Time
com.eoebooks.eoe	EoEbooks
com.epaga.IFAssistant	In-Flight Assistant
com.epic.mychart	MyChart
com.epicactiononline.ffxv.submission	Final Fantasy XV: A New Empire
com.epicwar-online.wiso300	Mobile Strike
com.epix.epixnow	EPIX NOW: Watch TV and Movies
com.erepubliklabs.warandpeace	War and Peace: Civil Clash
com.esfaxapp	Fax Plus Scanner - Tiny & Easy
com.espn.ScoreCenter	ESPN: Live Sports & Scores
com.etermax.preguntados	Trivia Crack
com.etermax.preguntados.pro	Trivia Crack (No Ads)
com.etermax.trivia.preguntados2	Trivia Crack 2
com.etermax.trivialadder	Trivia Crack Adventure
com.ethanbrimhall.Disney-Countdown	Countdown for Disney World
com.etoro.openbook	eToro Cryptocurrency Trading
com.etrade.mobileproiphone	E*TRADE: Invest. Trade. Save.
com.etsy.etsyforios	Etsy: Custom & Creative Goods
com.eurodate.ios	Dating.com: Meet New People
com.europosit.pixelcoloring	Pixel Art - Color by Number
com.eventbrite.attendee	Eventbrite
com.everlance.everlance	Everlance: Mileage & Expense
com.evernote.iPhone.Evernote	Evernote - Notes Organizer
com.everybodyhouse.paperclipsuniquetest	Universal Paperclips™
com.everydollar.EveryDollar	EveryDollar: Budget Your Money
com.everywear.game5	Merge Mansion
com.evilstudios.evilminds	Evil Minds: Dirty Charades!
com.evite.iphone.core	Evite: Party Invitations
com.evolve.podcast	The Podcast App
com.ewa.ewaapp	EWA: Learn English Language
com.excentus.frn	Fuel Rewards® program
com.exelerus.apps.ghostradio	Ghost EVP Radio - Paranormal
com.exozet.catan	Catan Classic
com.expedia.booking	Expedia: Hotels, Flights & Car
com.experian.experianapp	Experian Credit Report
com.explodingkittens.projectbombsquad	Exploding Kittens®
com.expressvpn.iosvpn	ExpressVPN - #1 Trusted VPN
com.eyu.music.tap.tap2	Tap Music 3D
com.facebook.Facebook	Facebook
com.facebook.Messenger	Messenger
com.facebook.PageAdminApp	Facebook Business Suite
com.facebook.games	Facebook Gaming
com.facebook.talk	Messenger Kids
com.facemetrics.asmr	TeasEar: ASMR Slime Antistress
com.fachat.freechat	Fachat: Online Video Chat
com.falldaysoftware.unicode	Unicode Character Viewer
com.familydollar.consumer	Family Dollar
com.fanduel.fd	FanDuel Fantasy Sports
com.fanduel.sportsbook	FanDuel Sportsbook & Casino
com.fansup.followersplus	Analyzer Plus-Followers Report
com.farfetch.discover	FARFETCH — Shop the new season
com.farmadventure.global	Family Farm Adventure
com.fatih.mesih	Messiahs
com.fayju.amazingfrog	Amazing Frog?
com.fboweb.MyRadar	MyRadar Weather Radar
com.fboweb.MyRadarPro	MyRadar Weather Radar Pro
com.fcagroup.us.nguaa	Uconnect
com.featherweightgames.stampede	Rodeo Stampede: Sky Zoo Safari
com.fedex.mobile.home	FedEx Mobile
com.feelingtouch.hitcents.godfather	The Godfather Game
com.feelthemusi.musi	Musi - Simple Music Streaming
com.feelty	Presets for Lightroom - FLTR
com.fengiiley.frlegends	FR Legends
com.feralinteractive.companyofheroes-ios	Company of Heroes
com.feralinteractive.gridautosport-ios	GRID™ Autosport
com.feralinteractive.rome-ios	ROME: Total War
com.feralinteractive.romealex-ios	ROME: Total War - Alexander
com.feralinteractive.romebi-ios	ROME: Total War - BI
com.feralinteractive.tropico3-ios	Tropico
com.feralinteractive.xcom2-ios	XCOM 2 Collection
com.fgol.HungrySharkEvolution	Hungry Shark Evolution
com.fiddlemeragged.fallingfruit	Falling Fruit
com.fidelity.watchlist	Fidelity Investments
com.fidget.buttons.antistresskit.box.ktale	Fidget Box 3D Antistress Toys
com.fifthstarlabs.skyguide	Sky Guide
com.fiftytwo.kensho	Kenshō
com.fighterverses.iphone	Fighter Verses: memorize Bible
com.filippello.filelinked	Filelinked
com.fillword.cross.wordmind.ios.en	Word Crossy - A crossword game
com.filmicpro.firstlight	FiLMiC Firstlight - Photo App
com.finaldraft.Final-Draft-Writer	Final Draft Mobile
com.fingersoft.hillclimbracing	Hill Climb Racing
com.fingersoft.hillclimbracing2	Hill Climb Racing 2
com.finishline.winnerscircledist	Finish Line – Shop Sneakers
com.firebyte.MakeoverRun	Makeover Run
com.firelitstudios.monogram.Monogram-It	Monogram It!
com.firemaplegames.returntogrislymanor	Return to Grisly Manor
com.fireplusteam.bunsinvasion	Bun Wars: Best of fun for Boys Girls and Kids
com.firescore.hairsalon	Hair Dye!
com.firescore.soapcutting	Soap Cutting
com.firstphorm.apps	1st Phorm
com.firsttouch.dls7	Dream League Soccer 2021
com.firsttouch.hero2	Score! Hero 2
com.firsttouch.story	Score! Hero
com.fis.ebt.consumerapp	ebtEDGE
com.fishbrain.app	Fishbrain - Fishing App
com.fishinggames.fishing	TAP SPORTS Fishing Game
com.fitbit.FitbitMobile	Fitbit: Health & Fitness
com.fitbod	Fitbod Workout & Fitness Plans
com.fitcoach	Fitness Coach & Diet: FitCoach
com.fitingo.fitness	Fitingo®- Weight Loss Workouts
com.fitnesslabs.airtag	Body Tune: Slim & skinny photo
com.fitnow.loseit	Lose It! – Calorie Counter
com.fitonapp.fiton	FitOn Workouts & Fitness Plans
com.fitradio.mobileapp	Fit Radio: Train Inspired
com.fits.essentials6	Firefighting I/II Exam Prep
com.fivebits.emergencydispatch	911 Emergency Dispatcher
com.fivemobile.wattpad	Wattpad - Read & Write Stories
com.fiverr.fiverr	Fiverr - Freelance Services
com.fixdapp.fixd	FIXD OBD2 Scanner
com.flambestudios.videoinframe	PicPlayPost Movie Video Editor
com.flamefrontstudios.forzatune7	ForzaTune Pro
com.flamingogamestudio.basketballlife3d	Basketball Life 3D
com.flamingogamestudio.parentlife3d	House Life 3D
com.flappdev.ifonts	AnyFont
com.flashbulb.mtcob	Max - The Curse of Brotherhood
com.flexilis.security	Lookout Mobile Security
com.flipline.papasbakeriatogo	Papa's Bakeria To Go!
com.flipline.papasburgeriatogo	Papa's Burgeria To Go!
com.flipline.papascheeseriatogo	Papa's Cheeseria To Go!
com.flipline.papascupcakeriatogo	Papa's Cupcakeria To Go!
com.flipline.papasdonuteriatogo	Papa's Donuteria To Go!
com.flipline.papasfreezeriatogo	Papa's Freezeria To Go!
com.flipline.papashotdoggeriatogo	Papa's Hot Doggeria To Go!
com.flipline.papasmochariatogo	Papa's Mocharia To Go!
com.flipline.papaspancakeriatogo	Papa's Pancakeria To Go!
com.flipline.papaspastariatogo	Papa's Pastaria To Go!
com.flipline.papaspizzeriatogo	Papa's Pizzeria To Go!
com.flipline.papasscooperiatogo	Papa's Scooperia To Go!
com.flipline.papassushiriatogo	Papa's Sushiria To Go!
com.flipline.papastacomiatogo	Papa's Taco Mia To Go!
com.flipline.papaswingeriatogo	Papa's Wingeria To Go!
com.flippfly.racethesun	Race The Sun
com.flipps.fitetv	FITE - Boxing, Wrestling, MMA
com.flipread.novel	Flipread
com.flipsampler.flip	Flip Sampler
com.flolivingalisavitti.myfloapp	MyFLO Period Tracker
com.flowkey.app	flowkey – Learn Piano
com.fluffyfairygames.idleminertycoon	Idle Miner Tycoon: Gold Rush
com.flyfrontier.ios	Frontier Airlines
com.flyingdevelopmentstudio.infiniteflight	Infinite Flight Simulator
com.flyingnayeem.nmVideoMergerJune	Add Background Music To Video
com.flylitchi.litchi	Litchi for DJI Drones
com.fnf.mods	FNF Ultimate MOD Game
com.fnf.senpai	FNF Tankman- Music rhythm game
com.focus-home.mudrunner-mobile	MudRunner Mobile
com.fodmltd.OfficialF1	Formula 1®
com.fongo.international	Fongo World Edition
com.foolsdog.classic1910	Tarot!
com.footlocker.approved	Foot Locker - Shop Releases
com.forcereadiness.parachuting	Jumpmaster PRO Study Guide
com.forcereadiness.promote	PROmote - Army Study Guide
com.forcereadiness.usafpromotee5	PDG PROmote 2019-2021
com.ford.fordpass	FordPass
com.foreflight.ForeFlightMobile	ForeFlight Mobile EFB
com.forestapp.Forest	Forest - Stay focused
com.forever21.Forever21	Forever 21
com.foreverjune.app	PLANBELLA - Planner App
com.forevernine.texaspoker.ios	Holdem or Foldem: Texas Poker
com.forksoverknives.forks	Forks Plant-Based Recipes
com.formula1.ott	F1 TV
com.fotoable.mergetown	Mergical-Fun Magic Merge Game
com.fotocamapp	ArtCam-Wallpapers&Photo Editor
com.foxandsheep.littlekitten	Little Kitten -My Favorite Cat
com.foxnews.nation	Fox Nation: Celebrate America
com.foxnextgames.m3	MARVEL Strike Force: Squad RPG
com.freecloud.StackTheCountries	Stack the Countries®
com.freecloud.StackTheStates	Stack the States®
com.freecloud.StackTheStates2	Stack the States® 2
com.freeplay.runandfight	Join Clash
com.freshplanet.games.SongPop2	SongPop 2 - Guess The Song
com.frestudios.Phone-Buddy-for-Apple-Watch	Phone Buddy - Phone Lost Alert
com.friday.music	Friday Night Music Funkin Game
com.friendsgamesincubator.drawtheline	Draw The Line 3D
com.frogmindgames.badland2	BADLAND 2
com.frogmindgames.dodge	BADLAND
com.front9bg9342	Front 9
com.frontierdesign.videostar	Video Star
com.frontrow.vlog	VN Video Editor
com.froschmedia.skater	Skater - Skate Legendary Spots
com.frozenape.tempo	Tempo - Metronome with Setlist
com.ftt.boxingstar.gl.ios	Boxing Star
com.fulvio.Reflex	DSLR Camera
com.funcell.ninemonths	9 Months
com.fungames.battleroyale	Zooba: Zoo Battle Royale Games
com.fungames.battletanksbeta	War Machines: Tank Games World
com.fungames.blockcraft	Block Craft 3D: Building Games
com.fungames.colorbynumber	Color by Number：Coloring Games
com.fungames.colorfy	Colorfy: Art Coloring Game
com.fungames.mathapp	Math Learner: Learning Game
com.fungames.sniper3d	Sniper 3D: Gun Shooting Games
com.fungames.tennisclash	Tennis Clash: Live Sports Game
com.fungomedia.GC	GameChanger Baseball Softball
com.funnyigames.phonecasediy	Phone Case DIY
com.funplus.familyfarm	Family Farm Seaside
com.funslime.xplayer	Super Slime: Antistress & ASMR
com.funtomic.matchmasters	Match Masters ‎- PvP Match 3
com.furiousavocado.tiedye	Tie Dye
com.fuseboxgames.loveisland	Love Island The Romance Game
com.futurekeyapp	EasyLife-AI Face&Meditation
com.futuremind.adblock	AdBlock
com.futuremoments.micswappro	MicSwap Pro Microphone Modeler
com.futureplay.mergematch	Merge Gardens
com.fxnetworks.ios.FXNOW	FXNOW: Movies, Shows & Live TV
com.g5e.hiddencity	Hidden City
com.g5e.mahjongg	Mahjong Journey®: Tile Match
com.gabama.monoposto	Monoposto
com.gabrielvicente.anatomy	Muscle Trigger Points
com.gabrielvicente.finalLearnMusclesID	Learn Muscles: Anatomy
com.gagediell.GageDiell	Jack’d - Gay chat & dating
com.gaiam.gaiamtv.ios	Gaia TV Conscious Media
com.game.colorroll3d	Color Roll 3D
com.game.colorslime	Jelly Dye
com.game.foldpuzzle	Paper Fold
com.game.perfectwax3d	Perfect Wax 3D
com.game.sorting.3d	Sort It 3D
com.game.space.shooter2	Galaxy Attack: Space Shooter
com.game.zzss.ios	Fighter Z
com.game5mobile.lineandwater	Happy Glass
com.gameaccount.winston	TwinSpires Casino & Sports
com.gamebility.onet	Onnect – Pair Matching Puzzle
com.gamedevltd.wwh	World War Heroes: WW2 FPS PVP
com.gamegos.mobile.manorcafe	Manor Cafe
com.gamehivecorp.kicktheboss2R	Beat the Boss 2 (17+)
com.gameinsight.thetribezhd	The Tribez: Build a Village
com.gamelabs.gettysburg	Ultimate General™: Gettysburg
com.gameloft.asphalt8	Asphalt 8: Real Racing Game
com.gameloft.asphalt9	Asphalt 9: Legends
com.gameloft.despicableme2	Minion Rush
com.gameloft.disneykingdom	Disney Magic Kingdoms
com.gameloft.dragonmaniahd	Dragon Mania Legends - Fantasy
com.gameloft.gah	March of Empires
com.gameloft.nova3	N.O.V.A. 3: Premium Edition
com.gameloft.sonicrunner	Sonic Runners Adventure
com.games.cocktailgame	Mix and Drink
com.games.erase	Erase Games
com.gamesbynoe.accesscodezero	Access Code Zero
com.gamescafe.sallysspa	Sally's Spa
com.gamesoulstudio.Backflip-Madness	Backflip Madness
com.gamestart.datemaster	Perfect Date 3D
com.gamestop.powerup	GameStop
com.gamesworld.whos	Who's Your ......?
com.gametimeunited.gametime	Gametime - Last Minute Tickets
com.gamevil.basebss.ios.apple.global.normal	Baseball Superstars 2021
com.gamevilusa.mlbpilive.ios.apple.global.normal	MLB Perfect Inning 2021
com.gammonapps.landnav	Land Nav Assistant
com.ganstudio.AdultEmojiPro	Adult Emoji Pro & Animated Emoticons for Texting
com.gap.shopon	Old Navy: Fun, Fashion & Value
com.garafa.GPSKit	GPS Kit - Offline GPS Tracker
com.garageitaly.garage	Depop - Streetwear & Vintage
com.gasbuddymobile.gasbuddy	GasBuddy: Find & Pay for Gas
com.gauthmath.intelligence	Gauthmath - Students Must Have
com.gc.teammanager	GameChanger Team Manager (NEW)
com.geeker.kod	Game of Kings:The Blood Throne
com.geewa.smashingfour	Smashing Four: PVP Smash Hit!
com.geico.GloveBox	GEICO Mobile - Car Insurance
com.gemini.ios	Gemini: Buy Bitcoin Instantly
com.gemo.getitright	Get It Right!
com.gemsoftware.textme	Free Tone - Calling & Texting
com.generativemusic.Bloom	Bloom
com.genesismedia.Nebula.Horoscope	Nebula: Horoscope & Astrology
com.geniussoftware.GeniusScan	Genius Scan - PDF Scanner
com.georgebatchelor.birdalone	Bird Alone
com.gero.ms	360Guard protection & security
com.getdropbox.Dropbox	Dropbox: Cloud Storage, Backup
com.getepic.Epic	Epic - Kids' Books & Reading
com.getsomeheadspace.headspace	Headspace: Meditation & Sleep
com.getuptownapps.pocketscale	Pocket Scale - Quick Weight Tracker
com.gezellig.savethedate	Save the Date!
com.ghosthuntingtoolkit.ghostkit	Ghosthunting Toolkit
com.ghosttools.Xb7spPro	XB7 Pro Spirit Box
com.giants-software.fs18	Farming Simulator 18
com.giants-software.fs20	Farming Simulator 20
com.gibbsstudios.Camera-Lucida	Camera Lucida
com.gigantic.PoleDancer3D	You Go Girl!
com.gigantic.clawee	Clawee
com.gingerlabs.Notability	Notability
com.giorgiocalderolla.Wipr	Wipr
com.giphy.giphyformessenger	GIPHY: The GIF Search Engine
com.gismart.drumpads	Beat Maker Go - Make Music
com.gismart.karaoke	Karaoke Songs - Voice Singing
com.gjg.colorfill3d	Color Fill 3D
com.glitche.ios.glitcheapp	Glitché
com.globakeryco.ohsheglows	Oh She Glows
com.global.tmslg.ios	Puzzles & Conquest
com.global.ztmslg.ios	Puzzles & Survival
com.globaldelight.Camera-Plus	Camera Plus: Frame The Moments
com.globile.ios.MyContactsBackupPro	My Contacts Backup Pro
com.globo.hydra	Globoplay
com.glority.everlens	Mobile Scanner App - Scan PDF
com.glu.baseball21	MLB Tap Sports Baseball 2021
com.glu.dashtown	Diner DASH Adventures
com.glu.disneygame	Disney Sorcerer's Arena
com.glu.gordondashx	Restaurant DASH: Gordon Ramsay
com.glu.stardomkim	Kim Kardashian: Hollywood
com.glu.zbs	Left to Survive: Shooter PVP
com.glutenfreegames.dinosaursimulatortwo	Ultimate Dinosaur Simulator
com.glutenfreegames.eaglesimulator	Eagle Simulator
com.glutenfreegames.ultimatearcticsimulator	Ultimate Arctic Simulator
com.glutenfreegames.ultimatebirdsimulator	Ultimate Bird Simulator
com.glutenfreegames.ultimatehorsetwo	Ultimate Horse Simulator 2
com.glutenfreegames.ultimateliontwo	Ultimate Lion Simulator 2
com.glutenfreegames.ultimatewolftwo	Ultimate Wolf Simulator 2
com.gm.myChevrolet	myChevrolet
com.gma.water.connect.puzzle	Water Connect Puzzle
com.gma.water.sort.puzzle	Water Sort Puzzle
com.gmc.gmovies	UP Faith & Family
com.gnovel.originalstation	GoodNovel & Books Web Novels
com.goat.dsfglios	Dragon Storm Fantasy
com.goat.ksrgl	King's Throne
com.gobit.burgershop2.premium	Burger Shop 2 Deluxe
com.godaddy.Voice	SmartLine Second Phone Number
com.godzilab-games.IdleRPG	Crush Them All - Idle RPG
com.gogii.textplus	textPlus: Unlimited Text+Calls
com.gogo.nam	BringGo USA & CAN
com.goldsteintech.skydroid	SkyDroid - Golf GPS
com.golfgps.golflogix	GolfLogix Golf GPS + Putt Line
com.goo.slime	Goo: Slime simulator, ASMR
com.goodgamestudios.bigfarmmobileharvest	Big Farm: Mobile Harvest
com.goodiware.goodreader4	GoodReader PDF Editor & Viewer
com.goodnotesapp.x	GoodNotes 5
com.goodrx.iphone	GoodRx: Prescription Coupons
com.google.Authenticator	Google Authenticator
com.google.Chromecast	Google Home
com.google.Classroom	Google Classroom
com.google.Docs	Google Docs: Sync, Edit, Share
com.google.Drive	Google Drive
com.google.Dynamite	Google Chat
com.google.GVDialer	Google Voice
com.google.Gmail	Gmail - Email by Google
com.google.GoogleMobile	Google
com.google.Jam	Jamboard
com.google.LightCycle	Google Street View
com.google.Maps	Google Maps - Transit & Food
com.google.OPA	Google Assistant
com.google.Sheets	Google Sheets
com.google.Slides	Google Slides
com.google.Tachyon	Google Duo
com.google.Translate	Google Translate
com.google.b612	Google Earth
com.google.calendar	Google Calendar: Get Organized
com.google.chrome.ios	Google Chrome
com.google.hangouts	Hangouts
com.google.ios.youtube	YouTube: Watch, Listen, Stream
com.google.ios.youtubekids	YouTube Kids
com.google.ios.youtubemusic	YouTube Music
com.google.ios.youtubeunplugged	YouTube TV
com.google.ios.ytcreator	YouTube Studio
com.google.keyboard	Gboard – the Google Keyboard
com.google.meetings	Google Meet
com.google.paisa	Google Pay: Save, Pay, Manage
com.google.photos	Google Photos
com.gopotluck.over	Over: Graphic Design Creator
com.gopro.GoPro	GoPro Quik
com.gopuff.gopuff	Gopuff—Alcohol & Food Delivery
com.gorilla.brass	Brass - Custom Icons & Widgets
com.gosub60.sol5	Solitaire Deluxe® 2: Card Game
com.gotgametech.turkeytech	Turkey Tech
com.gotham.insta	Followers: for Instagram
com.gotit.inc	GOTit - Social Shopping
com.gottaGolf.golfTracerApp	The Golf Tracer
com.govision2020.Locator	Offender Locator
com.gpapps.ptrackerlite	Period Tracker by GP Apps
com.gplexdb.azulbrowse	Red Onion - Tor-powered web browser for anonymous browsing and darknet
com.gplexdb.btcminer	Bitcoin Miner CPU (BTC) Gold
com.gpsnavx.iNavX	iNavX: Marine Navigation
com.grailed.production	Grailed - Buy & Sell Clothing
com.grailr.CARROT	CARROT To-Do
com.grailr.CARROTalarm	CARROT Alarm - Talking Alarm Clock
com.grailr.CARROTfit	CARROT Fit
com.gramgames.mergedragons	Merge Dragons!
com.gramgames.mergemagic	Merge Magic!
com.grammarly.keyboard	Grammarly - Keyboard & Editor
com.grandegames.slots.casino.free.ios	Vegas Friends - Casino Slots
com.graphsim.FA18	FA18 HORNET FIGHTER JET
com.grasshopperapps.sightwordsninja	Sight Words Ninja - Slicing Game to Learn to Read
com.gravity.romgi	Ragnarok M - Eternal Love
com.gravitysensation.isumo2	Sumotori Dreams
com.gravitytank.dscoutApp	dscout
com.greendotcorp.go2bank	GO2bank: Mobile banking
com.greendotcorp.mobilebanking	Green Dot - Mobile Banking
com.greendotcorp.walmartmoneycard	Walmart MoneyCard
com.greenheartgames.gdtmobile	Game Dev Tycoon
com.greenlight	Greenlight Debit Card for Kids
com.grimdev.grimquest	Grim Quest - Old School RPG
com.grinasys.runningforweightlosspro	Weight Loss Running by Verv
com.grinasys.walkingfree	Weight Loss Walking by Verv
com.grindrguy.grindrx	Grindr - Gay chat
com.groundspeak.GeocachingIntro	Geocaching®
com.groupme.iphone-app	GroupMe
com.groupon.grouponapp	Groupon
com.grubhub.delivery	Grubhub for Drivers
com.grubhub.search	Grubhub: Local Food Delivery
com.gsn.gsncasino	GSN Casino: Slot Machine Games
com.gsn.ios.tripeaks2	Solitaire TriPeaks Card Game
com.gtarcade.ioe.global	Infinity Kingdom
com.gtarcade.lods	Legacy of Discord-FuriousWings
com.gtm.drinkingwheel	Drink Roulette: Drinking Games
com.guidedways.iPrayPro	iPray
com.gym.racegame	Epic Race 3D
com.gypsyguide.gypsyguide.gtts	Going to the Sun Road GyPSy
com.gypsyguide.gypsyguide.yellowstonegrandtetoncombo	Yellowstone Grand Teton GyPSy
com.h8games.falldown	Helix Jump
com.habby.archero	Archero
com.haegin.homerunclash	Homerun Clash
com.hagiang.NhatCuaNhung	Filza: File Manager & Viewer
com.haiku.adventure.escape.game.mystery.stories	Adventure Escape Mysteries
com.halfbrick.FruitNinjaLite	Fruit Ninja®
com.halfbrick.fruitninjax	Fruit Ninja 2
com.halfbrick.jetpack	Jetpack Joyride
com.halfspace.ios.sculptura-pocket	Sculptura Pocket
com.hammerandchisel.discord	Discord - Talk, Chat, Hang Out
com.handsomeoldtree.idlefirefightertycoon	Idle Firefighter Tycoon
com.handy.pro	Handy for Pros
com.handypadsoft.carrierlandingipad	Carrier Landing HD
com.hanna.cleanup.guy	Cover The Tracks
com.happiest.sleepiest	Sleepiest Sleep Sounds Stories
com.happymagenta.fromcore	Tomb of the Mask
com.happymod.gametrack	HappyMod - Game Tracker
com.happyprinter.game	Happy Printer
com.happytech.chargingshow	Charging Show: Cool Animation
com.harmonicdog.MultiTrack	MultiTrack DAW
com.hashifytech.stickers	Sticker Babai: Telugu Stickers
com.hassan.fansapp	Only fans Explore Hub
com.hatsproductions.OrganTrail	Organ Trail: Director's Cut
com.hbo.hbonow	HBO Max: Stream TV & Movies
com.headupgames.bridgeconstructor	Bridge Constructor
com.headway.books	Headway: Self-Growth Challenge
com.heavydutyapps.RunC25K-Free	5K Runner: Couch to 5K Trainer
com.heavydutyapps.gymWorkout	Workout: Gym workout planner
com.heliogames.a1	Westland Survival - Cowboy RPG
com.hellobrigit.Brigit	Brigit: Get $250. When Needed.
com.helloclue.clue	Clue Period & Cycle Tracker
com.hellofresh.HelloFresh	HelloFresh
com.hemispheregames.osmos	Osmos
com.hero8.black	EasyBlack 8
com.hero9.black	EasyBlack 9
com.herzick.houseparty	Houseparty
com.hf.Find-Lost-Device	Wunderfind: Find Lost Device
com.hg.bfbb	SpongeBob SquarePants
com.hg.titanquestedition	Titan Quest: Legendary Edition
com.hhp.magicEraser	Magic Eraser Background Editor
com.hibbett.hibbett-sports	Hibbett | City Gear – Sneakers
com.hiclub.translator	Go Translate:Photo Translator
com.hiddenpixelgames.pool	Pool Payday: 8 Ball Billiards
com.hifamily.HiDaddy	HiDaddy - pregnancy for Dads
com.hifive.sleepwell	Sleep Well!!
com.highcore.giantrush	Giant Rush!
com.hilarywilson.BirdSongUSAPlus	Chirp! Bird Songs & Calls USA
com.hilarywilson.ChirpOMaticUSA	ChirpOMatic USA - Bird Song ID
com.hilton.hhonors	Hilton Honors: Book Hotels
com.hily.ios	Hily Dating – Meet New People
com.hindsightlabs.paprika.ios.v3	Paprika Recipe Manager 3
com.hippochat.live	Hippo - Random Live Video Chat
com.hipsterwhale.crossy	Crossy Road
com.hit.master	Hit Master 3D: Knife Assassin
com.hitcents.stickmanepic	Draw a Stickman: EPIC
com.hkueck.colorsplash	Color Splash
com.hm.goe	H&M - we love fashion
com.hn.among.lockscreen	Among Lock Screen - App Lock
com.homedatasheet.iDamage	iDamage-Pushed
com.hookupdating	HUD™ - #1 Casual Dating App
com.hopper.flights	Hopper - Flight & Hotel Deals
com.horoscope.horome.app	Hint: Horoscope & Astrology
com.horsepower1.doorslammers2game	Door Slammers 2 Drag Racing
com.hortemo.photoguessr	Photo Roulette
com.hotels.HotelsNearMe	Hotels.com: Book Hotels & More
com.hotheadgames.ios.baseballbattle	Super Hit Baseball
com.hotschedules.hotschedules	HotSchedules
com.house.of.blackjack.free.online.casino	Blackjack 21 - HOB
com.hp.HP12C2	HP 12C Financial Calculator
com.hp.printer.control	HP Smart
com.hpcnt.azar	Azar - Video Chat
com.hsvg.vetapp	Horse Side Vet Guide
com.hualai.WyzeCam	Wyze
com.huanliao.tiya	Tiya-Team Up! Time to play.
com.huge.slots.casino.vegas.ios.avidly	Double Win Slots Casino Game
com.hulu.plus	Hulu: Stream movies & TV shows
com.humblebundle.Forager	Forager
com.humblebundle.slaythespire	Slay the Spire
com.hunt.royale	Hunt Royale
com.hunter.theodolite	Theodolite
com.huntstand.HuntStand	HuntStand
com.hutchgames.cccg	Top Drives – Car Cards Racing
com.hutchgames.formularacing	F1 Manager
com.hutchgames.rebelracing	Rebel Racing
com.huuuge.casino.slots	Huuuge Casino Slots Vegas 777
com.huuuge.casino.texas	Billionaire Casino Slots 777
com.huuuge.trafficpuzzle	Traffic Puzzle
com.hwzj.bothlive	BothLive
com.hyoungbin.PhotoWidget	Photo Widget : Simple
com.hypah.io.slither	slither.io
com.hyper.slingplane	Sling Plane 3D
com.hyperchat.dodochat	DODO - Live Video Chat
com.hyperdivestudio.papers-grade-please	Papers Grade Please!
com.hypergame.collectcubes	Construction Set - Toys Puzzle
com.hypgames.ultimategolf	Ultimate Golf!
com.i4software.binoculars	Binoculars
com.iScore5.APHG	iScore5 APHG
com.iScore5.APPY2016	iScore5 AP Psych
com.iScore5.APUSH	iScore5 APUSH
com.iScore5.APWH	iScore5 AP World History
com.ibotta.Ibotta	Ibotta: Save & Earn Cash Back
com.idevmobile.AutoCare	AutoCare
com.idlelawfirm.empiretycoon	Idle Law Firm: Justice Empire
com.idsoftware.Doom	DOOM
com.if.followerplus	Getinsup - Find Your Hot Posts
com.ifit.wolf	iFit: At-Home Fitness Workout
com.igg.castleclash	Castle Clash: Guild Royale
com.igg.ios.dressuptimeprincess	Time Princess: Dress Up
com.igg.ios.lordsmobile	Lords Mobile: Kingdom Wars
com.ignite.igniteslots	Ignite Classic Slots-Casino
com.igorkravtsov.ezmeasure	EzMeasure Virtual Tape Measure
com.igs.fafafa	Slots GoldenHoYeah-Casino Slot
com.igtracker.insights	Reports for Followers
com.ihandysoft.alarmclock.pro	Alarm Clock Pro
com.ihandysoft.flashlight.led.pro	Flashlight Ⓞ
com.ihandysoft.tipcalculator	iHandy Tip Calculator
com.ihd.beatsaber	Beat Blader 3D
com.ihoment.GoVeeSensor	Govee Home
com.ilbsoft.irelax	Relax Melodies: Sleep Sounds
com.ilyondynamics.bubbleShooterClassic	Bubble Shooter - Pop Bubbles
com.im30.ROE	Rise of Empires: Fire and War
com.im30.warz	Last Empire – War Z: Strategy
com.imageline.FLStudioMobileHD	FL Studio Mobile
com.imangi.templerun	Temple Run
com.imangi.templerun2	Temple Run 2
com.imc2.iHut	Pizza Hut - Delivery & Takeout
com.imdb.imdb	IMDb: Movies & TV Shows
com.immediasemi.ios.blink	Blink Home Monitor
com.immortals.ios.tw	Immortal Taoists-idle Games
com.imvu.mobilecordova	IMVU: 3D Avatar Creator & Chat
com.in-meteo.ventusky	Ventusky: Weather Maps
com.inadaydevelopment.cashcalculator	10bii Financial Calculator
com.incpt.mobis.CalculatorInfinite	Calculator ∞
com.incpt.mobis.GraphingCalculator84UMPlus	Graphing Calculator Plus
com.indeed.JobSearch	Indeed Job Search
com.indev.Plug-for-Terraria	Plug for Terraria
com.indev.clearvideo	ClearVideo
com.indev.plugtools.Plug-Tools-for-Minecraft	Plug Toolbox for Minecraft
com.indev.whatcall	WhatCall
com.inditex.zara.iphone	ZARA
com.infinitetiers.calendarapp	iCalendar
com.infinitypocket.flickhomerun	Flick Home Run !
com.ingka.ikea.app	IKEA
com.initechapps.growlr	GROWLr: Gay Bears Near You
com.innersloth.amongus	Among Us!
com.innogames.elvenar	Elvenar - Fantasy Kingdom
com.innogames.iforge	Forge of Empires: Build a City
com.innovative.vpn	СуbеrSес VРN
com.insertnamehere.VargoMasterApp	Vargo Anesthesia Mega App
com.instacart	Instacart: Grocery deliveries
com.instacart.shopper	Instacart Shopper: Earn money
com.instructure.icanvas	Canvas Student
com.interealtime.LightBoost	NightCap Camera
com.internet-rocks.codescanner	QR Code Reader - QrScan
com.internetreshenia.JumpyHorseShowJumping	Jumpy Horse Show Jumping
com.inthekillhouse.actionsquad	Door Kickers: Action Squad
com.inthekillhouse.doorkickers	Door Kickers
com.intsig.CamScanner	CamScanner + | OCR Scanner
com.intsig.CamScannerLite	CamScanner-PDF Scanner App
com.intuit.QBOiPad	QuickBooks Accounting
com.intuit.qbse	QuickBooks Self-Employed
com.intuit.turbotax	TurboTax: File Tax Return
com.investorplus1	Investor Plus
com.investvoyager.voyager-ios	Voyager - Buy Bitcoin & Crypto
com.invoice2go.plus	Invoice2go: Easy Invoice Maker
com.ios.LoveManuellas	Love, Manuela
com.ios.lovestory.moments	Moments: Choose Your Story
com.ios.riseofthekings	Rise of the Kings
com.iphonesoft3g.blackjack	Blackjack 21: Blackjackist
com.iphonesoft3g.texaspoker	Texas Hold'em Poker: Pokerist
com.ipreppress.KeystoneBio	Keystone Biology Practice Test
com.ipvanish.ios.IPVanish	IPVanish VPN: The Fastest VPN
com.irobot.home	iRobot Home
com.ironhidegames.frontiers	Kingdom Rush Frontiers
com.ironhidegames.ironmarines	Iron Marines - RTS Offline
com.ironhidegames.kingdomrush.elves	Kingdom Rush Origins TD
com.ironhidegames.kingdomrush4	Kingdom Rush Vengeance TD
com.isamcode.iTools	iTools - Pocket Multi Tool
com.isd.retouchme	Retouch Me: Body & Face Editor
com.isharing.iSharing-Lite	iSharing: GPS Location Tracker
com.itbigkeeper.safevpn	SafeVPN - Best Wi-Fi Security
com.itchmedia.ta3	Baseball Boy!
com.itdevstudia.homeworkhelper	Homework_Helper
com.itwcalculator.fullscreenradarusa	Storm Tracker Pro
com.iuniform.app	iUniform ASU - Builds Your Army Service Uniform
com.ivdriprate.ivdriprateapp	ivDripRate
com.j2global.eFaxMobile	eFax App–Send Fax from iPhone
com.jackadam.darksky	Dark Sky Weather
com.jackpocket.JackPocket	Jackpocket Lottery App
com.jacob.gotya	GotYa! Camera Security & Safety
com.jacobcavin.shuttercast	ShutterCast
com.jadedlabs.arrive	Shop: package & order tracker
com.jadedpixel.shopify	Shopify - Your Ecommerce Store
com.jagex.oldschool	Old School RuneScape
com.jakemor.firness-ai	Personal Trainer – FitnessAI
com.jakob.pushdice	Dice Push
com.jamawkinaw.downcast	Downcast
com.james.poster	Poster Maker - Flyer Designer!
com.jardogs.FMHmobile	FollowMyHealth®
com.jcpenney.jcpenney	JCPenney – Shopping & Coupons
com.jcts.lyricparty	Lyric Party Game
com.jds.batds	Boris and the Dark Survival
com.jds.batim	Bendy and the Ink Machine
com.jedasoft.ghosthunterm2	Ghost Hunter M2
com.jedasoft.ghosthunterm3	Ghost Science M3
com.jedigames.zdjs.appstoretw	Three Kingdoms:Overlord
com.jellybtn.boardkings	Board Kings - Fun Board Games
com.jellybtn.cashkingmobile	Pirate Kings™
com.jetblue.jetBlueiPhone	JetBlue - Book & manage trips
com.jeyluta.camera7pro	Timestamp Camera Pro
com.jiangjia.gif	快手
com.jibjab.messages	JibJab
com.jimmyjohns.jimmyjohns	Jimmy John’s Sandwiches
com.jixipix.PortraitPaint	Portrait Painter
com.jixipix.SimplyHDR	Simply HDR
com.jloewy.mymacros	My Macros+ | Diet & Calories
com.johnehartzog.stickwars-siege	StickWars
com.joincarbon.nutrition	Carbon - Smart Diet Coach
com.joinhomebase.mobile	Homebase Employee Scheduling
com.joinhoney.honey	Honey Smart Shopping Assistant
com.joistapp.joist	Joist App for Contractors
com.joshuahart.PennyFinder	Penny Finder
com.joybits.iAlchemy	Doodle God™
com.joycity.gw	Gunship Battle Total Warfare
com.joycity.potc	Pirates of the Caribbean : ToW
com.joytunes.SimplyGuitar	Simply Guitar by JoyTunes
com.joytunes.asla	Simply Piano by JoyTunes
com.jpay.JPayActivity	JPay
com.jps.isaacguideplus	Guide+ for Binding of Isaac
com.jrustonapps.My-Lightning-Tracker-Pro	My Lightning Tracker Pro
com.jrustonapps.My-Moon-Phase-Pro	My Moon Phase Pro - Alerts
com.jtsstrength.juggernautai	JuggernautAI
com.juicemaster.superJuiceMe	Jason Vale’s Super Juice Me!
com.jumpgames.RealSteel	Real Steel
com.jundroo.SimplePlanes	SimplePlanes
com.jundroo.SimpleRockets	SimpleRockets
com.jundroo.SimpleRockets2	SimpleRockets 2
com.jutsugames.operator	911 Operator
com.juzi.balls	球球大作战
com.kabam.marvelbattle	Marvel Contest of Champions
com.kad.ohgod	Oh God!
com.kadama.kadama	Kadama - Find a Tutor
com.kaeria.vpssmobile	Face & Body Photo editor
com.kaigangames.game27	SIMULACRA
com.kaigangames.game32	SIMULACRA 2
com.kairos.duet	Duet Display
com.kairosoft.gm08E	Game Dev Story
com.kairosoft.gm29	Pocket Academy
com.kakaogames.gdts	Guardian Tales
com.kamediendesign.CalWatch	Calendar Timeline
com.kaname.surya.ios.zoomcamera	Zoom 100x Camera
com.kappa.icare	iCare - Find Location
com.kappsmart.ttb	Truth Table Builder
com.kathleenOswald.solitaire	Solitaire·
com.kayac.ball-run	Ball Run 2048
com.kayac.park-master	Park Master
com.keepsafe.KeepSafe	Secret Photo Vault - Keepsafe
com.ken.hotelmaster	Hotel Master 3D
com.kenditech.manualcamera	Manual Camera - Full Controls
com.kentaroid.kirakira	kirakira+
com.ketchapp.rider	Rider
com.ketchapp.screamhero	Scream Go Hero
com.kevinmangan.tracetable	Trace Table
com.keyboard.colorkeyboard	New Emoji & Fonts - RainbowKey
com.kfc.us.mobile	KFC US - Ordering App
com.kfteausa.kungfutea.ios	Kung Fu Tea
com.khuala.imgtool	CropSize: Photo Resizer Editor
com.kicksonfire.kicksonfire	KicksOnFire - Shop Sneakers
com.kik.chat	Kik
com.killerfishgames.atlanticfleet	Atlantic Fleet
com.killmondaygames.franbowchapter1	Fran Bow Chapter 1
com.killmondaygames.franbowchapter2	Fran Bow Chapter 2
com.killmondaygames.franbowchapter3	Fran Bow Chapter 3
com.killmondaygames.franbowchapter4	Fran Bow Chapter 4
com.killmondaygames.franbowchapter5	Fran Bow Chapter 5
com.killmondaygames.littlemisfortune	Little Misfortune
com.kilogroup.dofasting	DoFasting - Fasting Tracker
com.kiloo.subwaysurfers	Subway Surfers
com.kinegictechnology.picscam	PicsCam-Cartoon Photo Editor
com.kinemaster.app	KineMaster - Video Editor
com.kingsgroup.ss	State of Survival Walking Dead
com.kingsgroup.ww2	Z Day: Hearts of Heroes
com.kinoni.epoccamhd	EpocCam Webcamera for Computer
com.kiragames.UnblockMe	Unblock Me Premium
com.kissasian.drama	Kiss Asian
com.klab.bleach	BLEACH Brave Souls - 3D Action
com.klarna.app	Klarna | Shop now. Pay later.
com.kleientertainment.dontstarvepocket	Don't Starve: Pocket Edition
com.klovercredit.ios-app-production	Klover: $250 Cash Advance
com.kmonkey.predatorviewer	Predator Viewer
com.kobe.watermarkmaker	Watermark Photo: Add Copyright
com.kohls.mcommerce.iphone	Kohl's - Shopping & Discounts
com.kongregate.mobile.adventurecapitalist	AdVenture Capitalist
com.kongregate.mobile.adventurecommunist	AdVenture Communist
com.kongregate.mobile.throwdown	Animation Throwdown: CCG
com.kpgame.PokerBros	PokerBROS - Your Poker App
com.kraftwerk9.rokie	Rokie - Roku Remote
com.kraken.trade.app	Kraken Pro
com.kroger.krogermobile	Kroger
com.kronos.workforcemobileapp	UKG Workforce Central
com.ksgmobileinc.showmevegasslotsv2	Show Me Vegas Slots Casino App
com.kucoin.KuCoin.iOS	KuCoin
com.kumlah.sonopro	Sono X10 Spirit Box PRO
com.kumobius.duet	Duet Game
com.kura.save	Save them all - drawing puzzle
com.kvurd.milgps	MilGPS
com.kwalee.bladeforge3d	Blade Forge 3D
com.kwalee.drawit	Draw it
com.kwalee.letsbecops	Let's Be Cops 3D
com.kwalee.makeoverstudio	Makeover Studio 3D
com.kwalee.objecthide	Object Hunt
com.kymatica.AudioShare	AudioShare
com.lacivert.poledance	Pole Dance!
com.lafitness.lafitness	LA Fitness Mobile
com.lakenavi.wake	Wake  [Lake Norman]
com.lakeviewlabs.LittleNugget	Little Nugget: Baby Milestones
com.lapisltd.ios.vpnguard	VPN Guard & Wifi Proxy
com.laroapps.InstagramAnalytics	Reports: Followers Tracker
com.lasting.lastingapp	Lasting: Marriage & Couples
com.lastpass.ilastpass	LastPass Password Manager
com.latenitesoft.CameraPlus2	Camera+ 2
com.laubrothersllc.BabyArt	Precious - Baby Photo Art
com.lavin-apps.laxtimer	LAX Time & Score
com.ld.TakeBrowser	Alook Browser - 2x Speed
com.ldw.fishtycoon	Fish Tycoon
com.ldw.vf	Virtual Families
com.ldw.vf3	Virtual Families 3
com.ldw.vv2	Virtual Villagers 2
com.ldw.vv3	Virtual Villagers 3
com.ldw.vv4	Virtual Villagers 4
com.ldw.vv5iPhone	Virtual Villagers 5
com.lebada.adblock	AdBblock X Protection
com.lebleby.gearrace	Gear Race 3D
com.leftbrainrightbrain.stylebook	Stylebook
com.leftover.CoinDozer	Coin Dozer
com.lemon.lvoverseas	CapCut
com.lemonchiligames.kidos	Boop Kids - My Avatar Creator
com.lenzetech.argun2018	ARGun2018
com.leonbeecham.volumepro	Volume Booster : Bass Boost Me
com.leosfortune	Leo's Fortune
com.lesta.bowling	Bowling Crew
com.lexwarelabs.goodmorning	Sleep Cycle - Sleep Tracker
com.lezhin.comics	Lezhin Comics-Premium Webtoons
com.lf.monogram.cricut.silhouette	Monograms for Cricut Cutting
com.lgdstudio.ilivegold	i Live - Gold Edition
com.lgeha.nuts	LG ThinQ
com.liability.Earth-Clock	Living Earth - Clock & Weather
com.liaoyuan.huo.FKCamera.Full	ProMovie Recorder +
com.life360.safetymap	Life360: Find Family & Friends
com.lifewaresolutions.deluxemoonpro	Deluxe Moon Calendar & Phases
com.liftapp.mycat	My Cat! – Virtual Pet Games
com.liftapp.threetiles	3 Tiles - Tile Matching Master
com.liftstory.me.app	Lift: Story Maker
com.lightricks.Antares	Boosted Ad Maker by Lightricks
com.lightricks.Enlight-Editor	Photoleap by Lightricks
com.lightricks.Enlight-Phoenix	Motionleap by Lightricks
com.lightricks.Enlight-Photos	Lightleap by Lightricks
com.lightricks.Enlight-Video	Videoleap Editor by Lightricks
com.lightricks.Facetune	Facetune
com.lightricks.Facetune2	Facetune2 Editor by Lightricks
com.lightricks.FacetuneVideo	Facetune Video by Lightricks
com.lightricks.Lightwave	Beatleap by Lightricks
com.lightspace.lmk	LMK: Make New Friends
com.liguangming.Shadowrocket	Shadowrocket
com.lihuhu.matchingtriple	Match Triple 3D: Matching Tile
com.lileping.photoframepro	Photo Collage Maker PicJointer
com.lilithgame.abigame	Abi: A Robot's Tale
com.lilithgame.hgames.ios	AFK Arena
com.lilithgame.roc.ios	Rise of Kingdoms
com.lilithgame.sgame	Art of Conquest
com.limebike	Lime - Your Ride Anytime
com.limepresso.logomaker	Logo Maker Shop:Design Creator
com.limeturtle.nexomon	Nexomon
com.limmercreative.emtplusapp	EMT Review Plus
com.limmercreative.passengine.emt	EMT PASS (new)
com.linebreak.smartags	Likes Up - Smart Tags & Space
com.linecorp.LGTMTMG	LINE: Disney Tsum Tsum
com.linegames.sl	SMASH LEGENDS
com.linemanguide.lineman	Lineman Guide
com.lingodeer	LingoDeer - Learn Languages
com.linkedin.LinkedIn	LinkedIn: Network & Job Finder
com.linksideslabs.stickerstudio	Sticker Studio-Funny Stickers
com.linqsoft.diamondpainting	Diamond Painting ASMR Coloring
com.linsunstd.musicgame.musicnote	Music Arrow : FNF Game
com.lionsgate.mucho-movies	Pantaya
com.lionstudios.hookedinc	Hooked Inc: Fisher Tycoon
com.lipsar.cannondemolition	Cannon Demolition
com.lisbonlabs.faceinhole	FACEinHOLE®
com.literatureandlatte.scrivener.ios	Scrivener
com.literautas.StoryPlanner	Story Planner for Writers
com.littlecaesars.customer	Little Caesars
com.littleengine.wordtreat	WordTrip - Word Search Puzzles
com.littleengine.wordtrek-crossword	Daily Themed Crossword Puzzles
com.littleleague.rulebooks	Little League Rulebook
com.live.juicy	Coco - Live Video Chat Coconut
com.livebird.VoiceRecorder	Voice Recorder - Audio Record
com.livetechglobal.heyo	Heyo - Fun video chat!
com.livintis.repostplusapp	Repost+ for Instagram .
com.lockwoodpublishing.avakinlife	Avakin Life: 3D Avatar Creator
com.lodestonewireless.GPS-Debug	GPS Diagnostic: Satellite Test
com.lodos.ragdollfighter	Ragdoll Fighter
com.logicalengine.qsei	Invoice Simple, Estimate Maker
com.logmein.gotomeeting	GoToMeeting
com.logmein.gotowebinar	GoToWebinar
com.logsat.sexoffendersiphone	Sex Offenders Search iPhone
com.lojugames.Ordia	Ordia
com.longlifesetccc.wavechat	Wave Chat: Anonymous Chat
com.loop.match3d	Match 3D
com.loop.matchtile3d	Match Tile 3D
com.lovehottie.app	LoveHottie
com.lowes.mobile.consumer.iphone.lowes	Lowe's Home Improvement
com.loyalty.dutchbros	Dutch Bros®
com.lqlstudio.mirrorroku	Screen Mirroring - TV Cast
com.luckyday.app.bj	Lucky Day Blackjack Royale
com.ludia.dragons	Dragons: Rise of Berk
com.ludia.jurassicworld	Jurassic World™: The Game
com.ludia.jw2	Jurassic World Alive
com.ludia.lovelink	Lovelink™- Chapters of Love
com.luma-touch.LumaFX	LumaFX
com.luma-touch.LumaFusion	LumaFusion
com.luminouslabs.lumos	Lumos: Sun and Moon Tracker
com.lumoslabs.Lumosity	Lumosity: Brain Training
com.luna.dynomaster	Towing Race
com.lunabee.sg.onesafe4	oneSafe+ password manager
com.lunagames.stratego	Stratego ® Single Player
com.lunime.gachaclub	Gacha Club
com.lunime.gachalife	Gacha Life
com.luzala.Fontise2	Fontise - Font Maker Keyboard
com.lyft.ios.driver	Lyft Driver
com.lyst.lystapp	Lyst: Shop Fashion Brands
com.m-w.dictionary-premium	Merriam-Webster Dictionary Pro
com.machinezone.ody0	Game of War - Fire Age
com.machipopo.story17	LIVIT - 17LIVE(Live Streaming)
com.mad.DuckLifeSpace	Duck Life: Space
com.mad.ducklife	Duck Life
com.mageeks.trainsim	Train Simulator PRO 2018
com.mageeks.trucksim17	Truck Simulator PRO 2
com.magicappfactory.newsnapstill	SnapStill - Extract Photos From Video
com.magicnotion.matchmaker	Kitty Powers' Matchmaker
com.magicv.AirBrush	AirBrush - Best Photo Editor
com.magisto.magisto	Magisto Video Editor & Maker
com.magmic.NYTCrosswords09	New York Times Crossword
com.magneticzero.pennies	Pennies – Budget and Expenses
com.majorfrank.sneakerart	Sneaker Art!
com.mak.followers-analyzer	Followers Analyzer & Insights
com.make.it.fly	Make It Fly!
com.makesuperdream.3fun	3Fun: Threesome & Swingers App
com.manga.webcomics	WebComics - Daily Manga
com.mangolabs.stickered	Litstick - Best Stickers App
com.mann.iMate	iMetric Analyzer for Instagram
com.marmalade.battleship	BATTLESHIP
com.marmalade.cluedogame	Clue: The Classic Mystery Game
com.marmalade.gol2	The Game of Life 2
com.marmalade.golmobile	The Game of Life
com.marmalade.golv	THE GAME OF LIFE Vacations
com.marmalade.monopoly	Monopoly
com.maroieqrwlk.unpin	Pull the Pin
com.marriott.iphoneprod	Marriott Bonvoy
com.mars.avgchapters	Chapters: Interactive Stories
com.martinman.bestbabymonitor	Cloud Baby Monitor
com.marvel.unlimited	Marvel Unlimited
com.masomo.basketballarena	Basketball Arena
com.massimobiolcati.iRealBook	iReal Pro
com.masterclass.production	MasterClass: Learn New Skills
com.match.match.com	Match™ - #1 Dating App
com.matchingham.nailwomanrun	Nail Woman: Baddies Long Run
com.matchington.mansion	Matchington Mansion
com.mattel.HWInfiniteLoop	Hot Wheels Infinite Loop
com.mattel163.phase10	Phase 10: World Tour
com.mattel163.uno	UNO!™
com.matthewlberg.j23	J23 - Release Dates & Restocks
com.maverick.lobby	Lobby - Team up & Voice Chat
com.mayur.animaltransform	Animal Transform:Epic Race 3D
com.mazetheory.dwla	Doctor Who: Lonely Assassins
com.mc.footballstory	Football Story 3D
com.mcafee.mms	McAfee Mobile Security
com.mcdonalds.gma	McDonald's
com.mcmguides.2019.afh1.nco	AFH 1 Suite: NCO 2019-2021
com.me2zen.tripeaks	Solitaire TriPeaks Journey
com.mealime.mobile-app	Mealime Meal Plans & Recipes
com.mechanist.gok	Game of Khans
com.mediamushroom.copymydata2	Copy My Data
com.mediocre.grannysmith	Granny Smith
com.mediocre.smashhit	Smash Hit
com.medium.reader	Medium
com.meehan.iPhone.PRODUCTNAMErfc1034identifier	Text Light
com.meets.Meets	MICO: Make Friends, Live Chat
com.meevii.bibleKJV	Bible KJV - Daily Bible Verse
com.memrise.ios.memrisecompanion	Memrise: Fun Language Learning
com.mercariapp.ios.mercari	Mercari: Your Marketplace
com.merekdavis.Mextures	Mextures Photo Editor
com.mergedomhomedesign.game	Mergedom: Home Design
com.merkuryinnovations.geeni	geeni
com.metamoki.weed	Weed Inc: Idle Tycoon
com.metropcs.mymetro	MyMetro
com.mewe	MeWe Network
com.mgarrettcox.T9	T9 Predictive Keyboard
com.mgc.runnergame	Run Race 3D
com.mglstudio.boyvsblocks	Fat Pusher
com.mgs.sniper1	Sniper Strike: Shooting Game
com.miHoYo.GenshinImpact	Genshin Impact
com.miHoYo.bh3global	Honkai Impact 3rd
com.michaelclay.Cesium	Cs: Music Player
com.michaels.michaelsstores	Michaels Stores
com.microblink.PhotoMath	Photomath
com.microsoft.CompanyPortal	Intune Company Portal
com.microsoft.Office.Excel	Microsoft Excel
com.microsoft.Office.Outlook	Microsoft Outlook
com.microsoft.Office.Powerpoint	Microsoft PowerPoint
com.microsoft.Office.Word	Microsoft Word
com.microsoft.azureauthenticator	Microsoft Authenticator
com.microsoft.msedge	Microsoft Edge: Web Browser
com.microsoft.officemobile	Microsoft Office
com.microsoft.onenote	Microsoft OneNote
com.microsoft.skydrive	Microsoft OneDrive
com.microsoft.skype.teams	Microsoft Teams
com.microsoft.smartglass	Xbox
com.midasplayer.apps.bubblewitchsaga2	Bubble Witch 2 Saga
com.midasplayer.apps.bubblewitchsaga3	Bubble Witch 3 Saga
com.midasplayer.apps.candycrush4	Candy Crush Friends Saga
com.midasplayer.apps.candycrushjellysaga1	Candy Crush Jelly Saga
com.midasplayer.apps.candycrushsaga	Candy Crush Saga
com.midasplayer.apps.candycrushsodasaga	Candy Crush Soda Saga
com.midasplayer.apps.crash	Crash Bandicoot: On the Run!
com.midasplayer.apps.farmheroessaga	Farm Heroes Saga
com.midasplayer.apps.farmheroessupersaga	Farm Heroes Super Saga
com.midasplayer.apps.petrescuesaga	Pet Rescue Saga
com.midasplayer.apps.pyramidsolitairesaga	Pyramid Solitaire Saga
com.mimoza.photolift	Photolift - Face & Body Editor
com.mind.quiz.brain.out	Brain Out -Tricky riddle games
com.mindbodyonline.connect	Mindbody: Fitness, Salon & Spa
com.mindcandy.sleepstories	Moshi: Kids Sleep & Meditation
com.mindy.grap1	Stickman Hook
com.miniclip.8ballpoolmult	8 Ball Pool™
com.miniclip.agar.io	Agar.io
com.miniclip.basketballstars	Basketball Stars™
com.miniclip.footballstrike	Football Strike
com.miniclip.minifootball	Mini Football - Soccer game
com.miniseriesapps.minitube	MiniYT for YouTube
com.minogames.cats.beta	Cat Game - The Cats Collector!
com.mint.internal	Mint: Personal Finance & Money
com.mkarpenko.worldbox	WorldBox - God Sandbox
com.mkjigsaw.jigsawcollectionhd	Jigsaw Puzzle on iPad & iPhone
com.mlb.AtBat.2012.iPhone.MiLB.Full	MiLB First Pitch
com.mlb.AtBatUniversal	MLB
com.mlb.AtTheBallpark	MLB Ballpark
com.mlb.RBIBaseball19	R.B.I. Baseball 19
com.mlb.RBIBaseball20	R.B.I. Baseball 20
com.mlb.RBIBaseball21	R.B.I. Baseball 21
com.mntech.pocketsnipercn	Pocket Sniper!
com.mntech.strike	Strike.io
com.mobiblocks.TurkeyiPhoneAdFree	REAL Turkey Calls for Turkey Callin BLUETOOTH COMPATIBLE
com.mobilab.silhouettemagic	Silhouette Magic
com.mobilaurus.wingstopongroup2	Wingstop
com.mobile-softing.coinmaster	Coin Master
com.mobile.legends	Mobile Legends: Bang Bang
com.mobiledatalabs.goiq	MileIQ: Mileage Tracker & Log
com.mobilesuitgd.ios	MobileSuitGD
com.mobilewaronline.wwr.submission	World War Rising
com.mobilityware.SolitaireFree	Solitaire
com.mobitech3000.JotNotIPhone	JotNot Scanner App Pro
com.mobivio.cutecutpro	Cute CUT Pro
com.modesittsoftware.BoonDocking	Boondocking
com.modesittsoftware.RVDumpStations	RV Dump Stations
com.modesittsoftware.RoadTripPlanner	Road Trip Planner™
com.modesittsoftware.USFS-and-BLM-Campgrounds	USFS & BLM Campgrounds
com.modesittsoftware.Ultimate-CG	Ultimate US Public Campgrounds
com.modmaster.mcpe	Mods & Skins for Minecraft PE
com.modo.huazhiwuAbroad	Legend of the Phoenix
com.mog.AppIconzSpecial	AppIconz - Exclusive App Icons
com.mojang.minecraftpe	Minecraft
com.mokuroku.fisheye	Fisheye Lens - Lomo Camera
com.moneygram.us	MoneyGram® Money Transfers App
com.monkeyrun.chat	Monkey Run - Make New Friends
com.mono.carpin	Carpin - Find Family & Friends
com.moonlab.unfoldstories	Unfold — Story Maker & Collage
com.moonsted.madebyapp1	Marketplace - Buy and sell
com.moonton.mobilehero	Mobile Legends: Adventure
com.moowise.VPNghost	Ghost VPN - Best Secure VPN
com.more.dayzsurvival.ios	Last Shelter: Survival
com.motionone.afterfocus	AfterFocus
com.motivcode.muncher	Number Munchers
com.movcy.Movcy	Movcy - Movies, Shows, Music
com.move.Realtor	Real Estate App by Realtor.com
com.moxco.bumble	Bumble - Dating & Meet People
com.mpmf.truckemall	Truck'em All
com.msl.remote.samsungtv	Smart Remote for Samsung TV+
com.mtmapping.onxhunt	onX Hunt: #1 GPS Hunting Map
com.mtvn.BlazeiPhone	Blaze & the Monster Machines
com.mtvn.SBmoviegame	SpongeBob: Sponge on the Run
com.mtvn.betplus	BET+
com.mtvn.noggin	Noggin Preschool Learning App
com.mtvn.pawpatroladventurebay	PAW Patrol: Adventure Bay!
com.mtvn.tmntpp	TMNT: Portal Power
com.mujoysg.hxbb	Idle Angels
com.muntaha.tasVideoMergerJune	Video Maker with Music Editor
com.muratkul.stock	Get Rich! 3D
com.murka.casualslots	Casino Games - Infinity Slots
com.murka.scatterslots	Scatter Slots - Slot Machines
com.murka.slotsera	Slot Machines 777 - Slots Era
com.muscle.rush	Muscle Rush - Destruction Run
com.musclebooster	Workouts by Muscle Booster
com.music.battle	Music Battle FNF Game
com.mutual-app	Mutual - LDS Dating
com.muzmatch.muzmatch	muzmatch: Arab & Muslim dating
com.mw.blockDash	Block Dash Watch
com.mw.miniGamesForWatch	20 Watch Games - Classic Pack
com.mwb.sch3	Shopping Cart Hero 3
com.mwb.sch5	Shopping Cart Hero 5
com.mwm.guitartuner	Guitar Tuner Pro, Bass,Ukulele
com.my.defense	Rush Royale - Tower Defense TD
com.my.ffs.simulator.americandad	American Dad! Apocalypse Soon
com.my.hc.rpg.kingdom.simulator	Hustle Castle: Kingdom games
com.myYearbook.MyYearbook	MeetMe - Go Live, Chat & Meet
com.myapp.tlcexam	TLC Practice Exam
com.mydigitalearth.SibleyBirds2ndEd	Sibley Birds 2nd Edition
com.myfitnesspal.mfp	MyFitnessPal
com.myhealthsoftware.myallergies	mySymptoms Food Diary
com.myliftmaster.myq	myQ Garage & Access Control
com.mymacros.workout.My-Workout	My Workout+
com.mynetdiary.MyNetDiary	Calorie Counter - MyNetDiary
com.mynetdiary.MyNetDiaryPro	Calorie Counter PRO MyNetDiary
com.myoutdoortv.myoutdoortv	MyOutdoorTV: Hunt, Fish, Shoot
com.myscript.calculator	MyScript Calculator
com.mytona.seekersnotes.mysteriesofdarkwood	Seekers Notes: Hidden Mystery
com.mytonallc.cookingdiary	Cooking Diary® Restaurant Game
com.n3twork.funkopopblitz	Funko Pop! Blitz
com.n3twork.legendary	Legendary: Game of Heroes
com.n3twork.tetris	Tetris®
com.nag.welcomebaby	Welcome Baby 3D
com.nagastudio.attack.titan	Attack on Giants!
com.namconetworks.pacmanlite	PAC-MAN
com.nanobitsoftware.fashionnation	Fashion Nation: Style & Fame
com.nanobitsoftware.hollywoodstory	Hollywood Story: Fashion Star
com.nanobitsoftware.mystory	My Story: Choose Your Own Path
com.nanobitsoftware.taboo	Tabou Stories: Love Episodes
com.nanotribe.games.cashier3d	Cashier 3D
com.nasdastudios.nasdastudioswebstersdictionary	Webster's 1828 Dictionary USA
com.nathanroberts.FrostWebmPlayerBrowser	Frost WebM Player Browser
com.native-instruments.imaschine2	iMaschine 2
com.naturalmotion.customstreetracer2	CSR 2 Multiplayer Racing Game
com.naturalsynthetics.itsme	Itsme­
com.naver.linewebtoon	WEBTOON: Comics
com.navionics.SingleApp2013	Boating Marine & Lakes
com.nbaimd.gametime.universal	NBA: Live Games & Scores
com.nbcuni.cnbc.cnbcrtipad	CNBC: Stock Market & Business
com.nbcuni.com.nbcsports.liveextra	NBC Sports
com.nbcuni.nbc.portal	The NBC App – Stream TV Shows
com.nbcuni.parks.orlandoexperience	Universal Orlando Resort™
com.ndemiccreations.peaceinc	Rebel Inc.
com.ndemiccreations.plagueinc	Plague Inc.
com.ndemiccreations.scenariocreator	Plague Inc: Scenario Creator
com.nekki.shadowfight.paid	Shadow Fight 2 Special Edition
com.nekki.shadowfight3	Shadow Fight 3
com.nekki.vector.iphone	Vector for iPhone
com.nekki.vector2.paid	Vector 2 Premium
com.neocortext.doublicatapp	Reface: Face Swap Videos
com.neonfun.catalog	Episode - Choose Your Story
com.neowizgames.game.Baseball.Clash	Baseball Clash: Real-time game
com.nestlabs.jasper.release	Nest
com.netease.ddsfna	Stick Fight: The Game Mobile
com.netease.idv	Identity V
com.netease.ko	Knives Out
com.netease.mrzhna	LifeAfter
com.netflix.Netflix	Netflix
com.netgear.ntgrup	NETGEAR Nighthawk - WiFi App
com.netmarble.bnsmws	Blade&Soul: Revolution
com.netmarble.kofg	The King of Fighters ALLSTAR
com.netmarble.lin2ws	Lineage 2: Revolution
com.netmarble.mheros	MARVEL Future Fight
com.netmarble.nanagb	The Seven Deadly Sins
com.netmarble.war	Iron Throne: The Firstborn
com.netmarbleus.showtime	NBA Ball Stars
com.neural.ultra	Baby Ultrasound spoof
com.newclassic.doublerich	Double Rich！Vegas Casino Slots
com.newkline.avrpro	Awesome Voice Recorder PRO AVR
com.newsclapper.video	Clapper: Video Community
com.newtek.HX-Camera	NDI HX Camera
com.newtoyinc.NewWordsWithFriendsFree	Words With Friends – Word Game
com.nexon.maplem.global	MapleStory M: Fantasy MMORPG
com.nexonm.dominations	DomiNations
com.nextdoor.nextdoor	Nextdoor: Local Neighborhood
com.nextepisode.roperescue	Rope Rescue! - Unique Puzzle
com.nexters.titanhunters	Hero Wars - Fantasy World
com.nextgames.ios.ourworld	The Walking Dead: Our World
com.nextgames.twd	The Walking Dead No Man's Land
com.nextsol.workout.master	Idle Workout Master: MMA Fight
com.nextstepalliedhealth.clockyourself	Clock Yourself
com.nexvio.8mm	8mm Vintage Camera
com.neybox.Pillow	Pillow: Sleep Cycle Tracker
com.nfc.popl	Popl
com.ngelgames.herocantare	Hero Cantare with WEBTOON™
com.nguyenvh.holeio	Hole.io
com.nhl.gc1112.free	NHL
com.nhncorp.m2app	BAND - App for all groups
com.nianticlabs.hpwu.prod	Harry Potter: Wizards Unite
com.nianticlabs.pokemongo	Pokémon GO
com.nibbleapps.FitMenCook	Fit Men Cook - Healthy Recipes
com.nibblesnbits.ipcamviewer	IP Cam Viewer Pro
com.nightanddaystudios.peekaboobarn	Peekaboo Barn
com.nike.nikeplus-gps	Nike Run Club
com.nike.omega	Nike
com.nike.onenikecommerce	Nike SNKRS: Sneaker Release
com.niksoftware.snapseedforipad	Snapseed
com.nilu.androidtvremote	Universal TV Remote
com.nimbusgames.ngipeff1	Freddi Fish 1: Kelp Seeds
com.nimbusgames.ngipepj1	Pajama Sam: No Need To Hide
com.ninebuzz.beatsplus	Drum Beats+ Rhythm Machine
com.ninjakiwi.bloonstd5	Bloons TD 5
com.ninjakiwi.bloonstd6	Bloons TD 6
com.ninjakiwi.bloonstdbattles	Bloons TD Battles
com.ninjastormbr.ios	Ninja Storm: Origin
com.nintendo.zaba	Fire Emblem Heroes
com.nintendo.zaca	Animal Crossing: Pocket Camp
com.nintendo.zaga	Dragalia Lost
com.nintendo.zaka	Mario Kart Tour
com.nintendo.zara	Super Mario Run
com.nixhydragames.thearcana	The Arcana: A Mystic Romance
com.nixwang.decision	Tiny Decisions
com.noahgilmore.transparent-icons	Transparent App Icons
com.noctuasoftware.stellarium-mobile-plus	Stellarium PLUS
com.noodlecake.absolutedrift	Absolute Drift
com.noodlecake.chameleonrun	Chameleon Run
com.noodlecake.ssgpuzzle	Super Stickman Golf 2
com.noom.wlc	Noom
com.nordcurrent.canteenhd	Cooking Fever
com.nordcurrent.flyingfever	Airplane Chefs - Cooking Game
com.nordstrom.rack	Nordstrom Rack
com.nordvpn.NordVPN	NordVPN: VPN Fast & Secure
com.nosignalproductions.legacytwo	Legacy 2 - The Ancient Curse
com.notdoppler.EarntoDie	Earn to Die
com.notdoppler.EarntoDie2	Earn to Die 2
com.novadevelopment.freeprints	FreePrints – Photos Delivered
com.novasoftinteractive.Meridian-157-Chapter-2	Meridian 157: Chapter 2
com.novel.manga	iStory-Best Romance Webnovels
com.novelfox.foxnovel	FoxNovel-Read & Story Books
com.novelfox.novelcat	NovelCat-Novels and Books
com.novosoft.TurboScan	TurboScan™ Pro: PDF scanner
com.noxgroup.game.pinrescue	Pin Rescue
com.nscpartners.kcf	Kids Coin Fun
com.nttsolmare.game.ios.obeyme	Obey Me! - Anime Otome Sim -
com.nuclearunicorn.kittensgame	Kittens Game
com.nytimes.NYTimes	The New York Times
com.nytimes.cooking	NYT Cooking
com.oceanhousemedia.AAOMMindMatters	Mind Matters Meditations
com.oculus.twilight	Oculus
com.oecoway.friendly	Friendly Plus Social Browser
com.offerup.iphone.consumer	OfferUp - Buy. Sell. Letgo.
com.ofhuman.jour	Jour: Daily Self-Care Journal
com.ohbibi.fps	FRAG Pro Shooter
com.ohmgames.cheatandrun	Shortcut Run
com.ohmgames.geofinder	Trivia Planet!
com.okcupid.app	OkCupid: Online Dating App
com.okta.mobile	Okta Verify
com.olivestonelab.mooddiary	MOODA
com.omgmeditate.app	Breethe: Meditation & Sleep
com.omgpop.dmtmobile	Draw Something
com.omz-software.Pythonista3	Pythonista 3
com.onecast.ios	OneCast - Xbox Game Streaming
com.onemt.war.ar	انتقام السلاطين
com.onemt.wareternal	War Eternal
com.onemt.ww	Frontier Justice
com.oneothergame.7min-fitness	Workout for Women: Fitness App
com.ones.13	OBD2 Torque : OBDII Check Car
com.onethousandmoons.Tap-Tool-Pro	Tap Tool Pro
com.onethumbmobile.rpg	Celtic Heroes 3D MMO
com.oneway.Deathcoming	Death Incoming
com.onrose.Rose	Vibe - Make New Friends
com.onsongapp.onsong	OnSong Pro
com.ookla.speedtest	Speedtest by Ookla
com.openfit.openfit	Openfit - Fitness & Nutrition
com.openplanetsoftware.Just-Press-Record-for-iOS	Just Press Record
com.opera.OperaNews	Opera News: Breaking & Local
com.orangeorapple.flashcards	Flashcards Deluxe
com.oranginalplan.weaphones	Weaphones: Firearms Simulator Volume 1
com.oranginalplan.weaphonesvol2	Weaphones Firearms Simulator 2
com.orbitalknight.ridiculousfreekick	Crazy Kick!
com.orbitonline.b-hyve-pro	b-hyve pro
com.orbitz.iphoneprod	Orbitz Hotels & Flights
com.oringe.wordswag	Word Swag - Cool Fonts
com.orube.dwarfjourney	Dwarf Journey
com.os.airforce	1945 - Airplane shooting games
com.osfunapps.tv-vizio-remote-ios	Remote for Vizio
com.osmgolf.18Birdies	Golf GPS 18Birdies Scorecard
com.otdelkaplyus.pyrovpn	Pyro VPN - Secure & Unlimited
com.othertales.ticktockatalefortwo	Tick Tock: A Tale for Two
com.ouazgames.SpiderMaster	Web Master 3d!
com.outerspaceapps.itranslate	iTranslate Translator
com.outfit7.herodash	Talking Tom Hero Dash Run Game
com.outfit7.mytalkingangela	My Talking Angela
com.outfit7.mytalkingtom	My Talking Tom
com.outfit7.mytalkingtom2	My Talking Tom 2
com.outfit7.mytalkingtomfriends	My Talking Tom Friends
com.outplayentertainment.chefblast	Gordon Ramsay: Chef Blast
com.outrightgames.bratzfameandfashion	Bratz Total Fashion Makeover
com.ovelin.guitartuna	GuitarTuna: Guitar, Bass tuner
com.overdrive.dewey	Libby, by OverDrive
com.overhaulgames.baldursgateIIenhancededition	Baldur's Gate II: EE
com.overhaulgames.baldursgateenhancededition	Baldur's Gate
com.overhaulgames.nwnee	Neverwinter Nights
com.ovilex.trucksimulatorusa	Truck Simulator USA Evolution
com.pacer.pacerapp	Pacer Pedometer & Step Tracker
com.pacsun.pacsun	PacSun
com.pairroxz.smolovcalcapp	Smolov Squat Calculator
com.palmerperformance.DashCommand	DashCommand - OBD-II Gauges
com.pandarg.pxmobileapp	Panda Express
com.pandora	Pandora: Music & Podcasts
com.panerabread.mobile.minneapolis	Panera Bread
com.pangea.bug2	Bugdom 2
com.paninidigitalinc.blitz	NFL Blitz - Trading Card Games
com.panoramik.autochess	Auto Brawl Chess:Battle Royale
com.panoramik.forgeofgodsblitz	Mighty Party: Battle Heroes
com.panzerdog.tacticool	Tacticool
com.papajohns.ios	Papa John's Pizza
com.papaya.bubblecash	Bubble Cash
com.papaya.solitairecash	Solitaire Cash
com.paperboatapps.all-in-one	Kiddopia - ABC Toddler Games
com.paradyme.solarsmasher	Solar Smasher
com.parathyroid.Calcium-Pro	Calcium Pro
com.parentsware.ourpact	Parental Control App - OurPact
com.particlenews.newsbreak	News Break: Local Everything
com.partumapps.dagame	DaGame - DaBaby Game
com.pascaldreer.aeroweatherpro	AeroWeather Pro
com.pastapizza.qrcode	QR Code Reader ·
com.path36.SpliceFree	Splice - Video Editor & Maker
com.patreon.iphone	Patreon
com.patrickjmaloneyllc.HAMTestPrepG	HAM Test Prep:  General
com.paully.spyglass	Spyglass
com.paychex.paychexmobile	Paychex Flex
com.paycom.PaycomESS	Paycom
com.payfare.doordash	DasherDirect By Payfare
com.paylocity.paylocitymobile	Paylocity Mobile
com.paypal.merchant	PayPal Business: Invoice Maker
com.pctexams.cchtprep	CCHT PREP
com.pd.thecook	The Cook - 3D Cooking Game
com.pdawiz.nypenal.2014	NY Penal Law 2020
com.pdffiller.PDFfiller	pdfFiller: Document editor&pdf
com.peacocktv.peacock	Peacock TV: Stream TV & Movies
com.peaksystems.Diptic	Diptic
com.pearlabyss.blackdesertm.gl	Black Desert Mobile
com.pencil.madness	Pencil Rush 3D
com.pengcheng.thor	D-MEN：The Defenders
com.peoplefun.wordcross	Wordscapes
com.peoplefun.wordsearch	Wordscapes Search
com.peoplefun.wordstacks	Word Stacks
com.peoplemedia.blackpeoplemeet	Black People Meet
com.peoplemedia.ourtime	OurTime - Meet 50+ Singles
com.pepiplay.pepibath	Pepi Bath
com.pepiplay.pepihome	Pepi House
com.peppapig.partytime	Peppa Pig™: Party Time
com.peppapig.themepark	Peppa Pig™: Theme Park
com.perblue.disneyheroes.ios	Disney Heroes: Battle Mode
com.percent.royaldice	Random Dice : PvP Defense
com.performanceaudio.dbmeterpro	Decibel Meter Pro
com.peripheralbrain.journalclub	Journal Club: Medicine
com.perspective.Blue-Iris	Blue Iris
com.petco.mobile	Petco
com.petsmart.consumermobile	PetSmart, Inc.
com.phanotek.model3testdrive	Model 3 Test Drive
com.pheinex.DuctCalculator	Duct Calculator
com.philo.tv.philo	Philo: Live & On-Demand TV
com.phocusllp.due	Due - Reminders & Timers
com.phoenixsolutions.imetalbox	Toolbox™
com.phoenixsolutions.magnifier	Magnifier™
com.phoenixsolutions.quicksketch	Photo Sketch Pro+
com.phoenixsolutions.tapecalculatorpro	Carpenter Calculator Pro
com.phoenixsolutions.unitconverterpro	Unit Converter Pro++
com.phonato.casino.vegas.slots.machines.double.down.videopoker.craps.game	Vegas Slots - 7Heart Casino
com.phonetracker.findus	Cell Phone Tracker + by number
com.photo	Photo Lab: Picture Editor App
com.photo.beautytuneapp	Facelab - Face Editor & Beauty
com.photo.widget.theme.free	Color Widgets-Photo Widget.s
com.photomyne.photomyneapplite	Photo Scan App by Photomyne
com.photopills.photopills	PhotoPills
com.photoprohd	Photo Lab PROHD picture editor
com.phoxware.DMVTestPrepNM	New Mexico DMV Test Prep
com.physicsclassroom.iOSmop6	Minds On Physics - Part 6
com.picmonkey.picmonkey	PicMonkey Photo + Video Design
com.picolo.ios	Picolo · Party game
com.picsart.studio	PicsArt Photo & Video Editor
com.pictarine.Photo-Print	Print Photo - photo print app
com.picturerock.rock	Rock Identifier: Stone ID
com.pieyel.scrabble	Scrabble® GO - New Word Game
com.piispanen.hotelhideaway	Hotel Hideaway: Virtual World
com.pikpok.hrc.iosstore	Rival Stars Horse Racing
com.pinger.textfreeWithVoice	Text Free: Texting + Calling
com.pinpal.full	PinPal
com.pinpinteam.crowdbattle3d	Crowd Battle 3D
com.pinsotech.filto	Filto: Video Filters & Edit
com.pixelberrystudios.choices	Choices: Stories You Play
com.pixelbox.roofrails	Roof Rails
com.pixeldevelopers.discbotapp	MiniCord
com.pixelfederation.diggy	Diggy's Adventure Puzzle Games
com.pixelfederation.trainstationgame2	Train Station 2: Railroad Sim
com.pixelmatorteam.pixelmator.touch	Pixelmator
com.pixonic.wwr	War Robots Multiplayer Battles
com.pjmasks.racingheroes	PJ Masks™: Racing Heroes
com.planblabs.drops.italian	Drops: Fun Language Learning
com.planetfitness.lunkinator	Planet Fitness Workouts
com.planit2d.Planit2d	Planit2d
com.plarium.raidlegends	RAID: Shadow Legends
com.plarium.solitaire	Undersea Solitaire Tripeaks
com.plarium.vikings	Vikings: War of Clans
com.platinumcityllc.metadatapro	Metadata Pro
com.platinumplayer.word.addict.ios	Word Collect: Word Games
com.playdatedigital.herocandyland	CANDY LAND:
com.playdeadgames.limbo.ios	LIMBO
com.playdemic.golf	Golf Clash
com.playdigious.cultist	Cultist Simulator
com.playdigious.deadcells	Dead Cells
com.playdigious.northgard	Northgard
com.playesta.apocalypseinc	Apocalypse Inc.
com.playfirst.cookingdashx	Cooking Dash™
com.playgendary.bowmasters	Bowmasters - Multiplayer Game
com.playgendary.creammaster	Perfect Cream
com.playgendary.homes	Design Masters
com.playgendary.ktb2	Kick the Buddy: Forever
com.playgendary.polyspherecoolgame	Polysphere - art of puzzle
com.playgendary.tankstars	Tank Stars
com.playhome.hospital	My PlayHome Hospital
com.playhome.school	My PlayHome School
com.playhome.stores	My PlayHome Stores
com.playmatetennis.LikeMyDrill	Like My Drill
com.playrix.fishdom-freeplay	Fishdom
com.playrix.gardenscapes-m3-ios	Gardenscapes
com.playrix.gardenscapes-sweethome	Homescapes
com.playrix.manor-matters	Manor Matters
com.playrix.township-ios	Township
com.playrix.zoo-m3-ios	Wildscapes
com.playsportgames.mmm3	Motorsport Manager Mobile 3
com.playstation.eu.playstationadhoc	PlayStation App
com.playstation.psremoteplay	PS Remote Play
com.playstrom.bob	Comics Bob
com.playstrom.dop2	DOP 2: Delete One Part
com.playstudios.mykonami	my KONAMI - Real Vegas Slots
com.playstudios.myvegas	myVEGAS Slots – Casino Slots
com.playstudios.myvegas.bingo	myVEGAS Bingo - Casino Games
com.playstudios.popslots	POP! Slots ™ Live Vegas Casino
com.playtertainment.ww	Winner Winner Live Arcade
com.playtika.caesars.videoslots	Caesars Slots: Casino & Slots
com.playtika.slotomania	Slotomania™ Vegas Casino Slots
com.playtika.wsop	World Series of Poker - WSOP
com.playtoddlers.urbancitystories.full	Urban City Stories (Full)
com.pluckedstudios.machcalcpro	CNC Machinist Calculator Pro
com.plugindigital.cardquest	Card Quest : Card Combat
com.pnc.pncmobile	PNC Mobile Banking
com.pocketgems.dragon	War Dragons
com.pocketgm.PGM-21Beta	Pocket GM 21: Football Manager
com.pocketprep.app.behavioralhealth	Behavioral Health MSW LCSW NCE
com.pocketprep.app.ems	EMS Pocket Prep EMT Paramedic
com.pockettrend.neomonsters	Neo Monsters
com.pof.mobileapp.iphone	Plenty of Fish Dating
com.pointabout.cars	Cars.com - New & Used Cars
com.pointabout.washingtonpost	Washington Post
com.pokercruncher.PokerCruncher	PokerCruncher - Advanced Odds
com.polarapps.iredstone	iRedstone
com.polytron.fez	FEZ Pocket Edition
com.popcap.ios.PvZ2	Plants vs. Zombies™ 2
com.poqstudio.prettylittlething	PrettyLittleThing
com.portbliss.icycake	Icing on the Cake
com.poshmark.poshmark	Poshmark: Buy & Sell Fashion
com.possiblefinance.mobileios	Possible: Fast Cash & Credit
com.postmates.fleet	Postmates - Fleet
com.postmates.getitnow	Postmates - On-Demand Delivery
com.potatovpn	VPN PotatoVPN -Fast WiFi Proxy
com.powerschool.portal	PowerSchool Mobile
com.prax.multitasker	Split Screen Multitasking View
com.prayapp.pray	Pray.com: Prayer, Sleep, Bible
com.premiereradio.branded.rushlimbaugh	Rush Limbaugh
com.premiumstations.unlimited	Premium Music Stations - Unlimited
com.priceline.negotiator	Priceline - Hotel, Car, Flight
com.primatelabs.geekbench5	Geekbench 5
com.prisma-ai.app	Prisma Photo Editor
com.prisma-ai.lensa-app	Lensa: Photo & Picture Editor
com.privateinternetaccess.ios.PIA-VPN	VPN by Private Internet Access
com.privatesoft.distanceAreaMeasure	Planimeter Pro for map measure
com.privax.hmaprovpn	HMA Hotspot VPN & Proxy
com.productmadness.hovmobile	Heart of Vegas Casino Slots
com.productmadness.lightninglink	Lightning Link Casino Slots
com.productmadness.mrcashmancasino	Cashman Casino Las Vegas Slots
com.progressive.ProgressiveApp	Progressive
com.pronetis.ironballride2	Going Balls
com.propagata.squeezy	Squeezy NHS Pelvic Floor App
com.propel.ebenefits	Fresh EBT - Food Stamp Balance
com.ps17.ElectronicsDetector	Electronics Detector
com.psiquicos	Psíquicos - lectura psíquica
com.psoft.wristfeed	WristFeed for Instagram
com.ptfarm.Pokerrrr	Pokerrrr 2- Holdem, OFC, Omaha
com.purplekiwii.vegaslive	Vegas Live Slots Casino
com.puzzle1studio.ap.brickoutshoottheball	Brick Out - Shoot the ball
com.puzzle1studio.ap.bubblepoporiginpuzzlegame	Bubble Pop Origin! Puzzle Game
com.pwrd.pwm	Perfect World Mobile
com.pwrd.unrulyheroesmobile	Unruly Heroes
com.pz.life	Highrise - Virtual World
com.pzdate.cougard	#1 Cougar Dating App - CougarD
com.q1.xhero	X-HERO: Idle Avengers
com.qbiki.UScop	US Cop
com.qijitech.easysticker	Easy Stickers - Sticker maker
com.qjzj.ios.us4399	Raider: Origin
com.qoni.guesstheiranswer	Guess Their Answer
com.quadpay.mobile-app	Quadpay: Buy Now, Pay Later
com.quantumgames.skyscraper	Tower Craft 3D - Idle Building
com.qubetanetwork.aibox	Pics Shot-Face Editor&Cartoon
com.quizlet.quizlet	Quizlet
com.quok.blobRunner	Blob Runner 3D
com.quora.app.mobile	Quora
com.quvideo.VISO	Tempo - Music Video Maker
com.quvideo.XiaoYing	VivaVideo - Video Editor&Maker
com.qxmd.pedsGuide	Pedi STAT
com.radio.police.scanner.Scanner	Police Scanner, Fire Radio
com.radishfiction.app	Radish - Binge-worthy Stories
com.radpirates.herovscriminal	Hero VS Criminal
com.raftsurvival.raft	Raft Survival - Ocean Nomad
com.rain-frog.Yoga	Pocket Yoga
com.rainydayapps.Blockchain	Blockchain Wallet: Buy Bitcoin
com.raisingcanes.ordering	Raising Cane's Chicken Fingers
com.rarevision.vhs-camcorder	Rarevision VHS - Retro 80s Cam
com.rathasou.spyvoice	SP Voice Recorder
com.rawfury.longhathouse.Dandara	Dandara Trials of Fear Edition
com.raya.raya	Raya
com.rayark.Cytus.full	Cytus
com.rayark.cytus2	Cytus II
com.rayark.deemovr	DEEMO -Reborn-
com.rayark.pluto	DEEMO
com.rdamato.watchgames	Arcadia - Arcade Watch Games
com.readdle.PDFExpert5	PDF Expert: PDF Editor, Reader
com.readdle.ReaddleDocsIPad	Documents: Files, PDF, Browser
com.realbyteapps.MoneyManager	Money Manager (+PC Editing)
com.reboot.buildroads	Build Roads
com.reboot.lickrunner	Lick Runner
com.recreationslab.perfecttime	Perfect Time!
com.redcat.hypermarket	Hypermarket 3D
com.redcellgames.goldandgoblins	Gold and Goblins: Idle Merger
com.reddit.Reddit	Reddit
com.redemptiongames.sugar	Sweet Escapes: Build A Bakery
com.redfin.redfin	Redfin Real Estate: Find Homes
com.redkeysoftware.whirlyword	Whirly Word
com.redspritestudios.galaxoids	Kepler Attack
com.reederapp.5.iOS	Reeder 5
com.reflectly.app	Reflectly - Journal & AI Diary
com.regasoftware.udiscfree	UDisc Disc Golf
com.regoapps.CopRadioPro	Police Scanner +⁺
com.regularrateandrhythm.PerfectOBWheel	Perfect OB Wheel
com.relayrides.ios.RelayRides	Turo - Better Than Car Rental
com.relize.YogaForWeightLoss	Yoga 4 Weight Loss | JustYoga
com.remind101.Remind101	Remind: School Communication
com.remitly.remitly	Remitly: Transfer Money Abroad
com.renewedvision.proremote	ProPresenter Remote
com.replay.LeisureSuitLarryiOS	Leisure Suit Larry: Reloaded
com.reportallusa.landglide.LandGlide	LandGlide
com.reports.unfollowers.ios.app	Unfollow For Instagram Mass
com.represently.lure	Lure: Interactive Chat Stories
com.resonantcavity.Voloco	Voloco
com.reto3d.pro.version	RETO3D PRO
com.retromonkey.shoerace	Shoe Race
com.retronicgames.pixeldungeon	Pixel Dungeon
com.return7.BillMinder4	BillMinder®
com.rhapsody.iphone.Rhapsody3	Napster - Top Music & Radio
com.rhymezone.RhymeZone	RhymeZone
com.ridewithgps.mobile.ios	Ride with GPS: Bike Navigation
com.riffsy.RiffsyKeyboard	GIF Keyboard
com.ring	Ring - Always Home
com.ringtonesapp	Ringtones for iPhone: RingTune
com.riotgames.league.teamfighttactics	TFT: Teamfight Tactics
com.riotgames.league.wildrift	League of Legends: Wild Rift
com.ripostegames.shopr	Shop Titans: Craft & Build
com.risesci.nyx	Rise: Sleep & Energy Tracker
com.riseup.game	Rise Up
com.risingtidegames.blackdiamondslots.beta	SLOTS - Black Diamond Casino
com.rivergame.worldbattleGlobal	Top War: Battle Game
com.rkk.SmartClosetRN	Smart Closet - Fashion Style
com.rljentertainment.umc	ALLBLK
com.rmrlabz.directouch	DirectVR Remote for DirecTV
com.roadwarrior.ios	RoadWarrior Route Planner
com.robinhood.release.Robinhood	Robinhood: Investing for All
com.roblox.robloxmobile	Roblox
com.robnorback.HearingHelper	Hearing Helper - Live Captions
com.robotgentleman.game60parsecs	60 Parsecs!
com.robotgentleman.game60seconds	60 Seconds! Atomic Adventure
com.robotsandpencils.GypsyGuide.MIFIT	Maui GyPSy Guide Driving Tour
com.robotsandpencils.GypsyGuide.MIHA	Haleakala Maui GyPSy Guide
com.robotsandpencils.GypsyGuide.MIRH	Road to Hana Maui GyPSy Guide
com.robtop.geometrydashsubzero	Geometry Dash SubZero
com.robtop.geometryjump	Geometry Dash
com.robtop.geometryjumplite	Geometry Dash Lite
com.rockstargames.bully	Bully: Anniversary Edition
com.rockstargames.gta3ios	Grand Theft Auto III
com.rockstargames.gta3sa	Grand Theft Auto: San Andreas
com.rockstargames.gta3vc	Grand Theft Auto: Vice City
com.rockstargames.gtachinatownwars	GTA: Chinatown Wars
com.rockstargames.gtalcs	GTA: Liberty City Stories
com.rockstargames.maxpayne	Max Payne Mobile
com.rockwellventures.mesmerize	Mesmerize - Visual Meditation
com.rogue.under	Under: Depths of Fear
com.roku.ios.roku	Roku - Official Remote Control
com.roku.remote	TV Remote Control for TV
com.rollic.bouncehigh	Bounce Big
com.rollic.fitandsqueeze	Fit and Squeeze
com.rollic.tanglemaster3d	Tangle Master 3D
com.romocam	FILCA - SLR Film Camera
com.romwe.dotfashion	ROMWE - Fashion Store
com.ronimusic.asd	Amazing Slow Downer
com.roomster.ios	Roomster: Roommates & Rooms
com.rosettastone.totale.companionhd	Rosetta Stone: Learn Languages
com.rotowire.football2021draft	Fantasy Football Draft Kit '21
com.route4me.route4me	Route4Me Route Planner
com.rover.Rover-com	Rover—Dog Sitters & Walkers
com.rovio.abmatch3	Angry Birds Match 3
com.rovio.angrybirdsfriends	Angry Birds Friends
com.rovio.baba	Angry Birds 2
com.rovio.blast	Angry Birds Blast
com.rovio.dream	Angry Birds Dream Blast
com.rovio.projectcake	Sugar Blast: Pop & Relax
com.rovio.smalltownmurders	Small Town Murders: Match 3
com.rovio.stellapop	Angry Birds POP!
com.rp.rpdiet	RP Diet Coach
com.rpatechnology.airmouse	Mobile Mouse Remote
com.rtsixty.iDrumTuneProfessional	Drum Tuner - iDrumTune Pro
com.rtsoft.growtopia	Growtopia
com.rubygames.brainpuzzles	Brain Puzzle:Tricky IQ Riddles
com.ruikq.decar	Loon
com.runfaster5.slimto	Slime Simulator Fluid Games
com.runloop.seconds	Seconds Pro Interval Timer
com.rxsj.ios.en4399	Yong Heroes
com.ryanbond.PregnancyTracker	Pregnancy & Baby Tracker WTE
com.sabermoviefx.sabermoviefx	Saber Movie FX
com.sablostudio.dig.tycoon.idle.game	Dig Tycoon - Idle Game
com.sabre.travelocity	Travelocity Hotels & Flights
com.safariguard	SafariSafe Guard
com.saferkid.SaferKid	SaferKid Text Monitoring App
com.sagosago.Friends	Sago Mini World: Kids Games
com.saiyun.avgchapters.episodestories.romance	Romance Fate: Story Games
com.salontranscripts.STX	STX
com.samsclub.samsapp	Sam's Club
com.samsung.oneconnect4ios	SmartThings
com.samvermette.Transit	Transit • Subway & Bus Times
com.sanatate.shieldx	Shield X Protection
com.sante.webshield	Web Shield
com.sarahnorthway.rebuild2	Rebuild
com.sarahnorthway.rebuild3	Rebuild 3: Gangs of Deadsville
com.sarahsday.sezzytimer	Sezzy Timer
com.scanner.Fax	Fax from iPhone. Send receive
com.school.kid	Hyper School
com.schoology.schoology	Schoology
com.schumann-resonances.schumann-resonances	Schumann Resonance
com.science-inc.Yarn	Yarn - Chat & Text Stories
com.scientificgames.monopolyslots	MONOPOLY Slots - Slot Machines
com.scopely.headshot	Walking Dead: Road to Survival
com.scopely.startrek	Star Trek Fleet Command
com.scopely.wheeloffortune	Wheel of Fortune: Show Puzzles
com.scopely.whiplash	WWE Champions 2021
com.scopely.yux	Yahtzee® with Buddies Dice
com.scottgames.fivenights	Five Nights at Freddy's
com.scottgames.fivenights3	Five Nights at Freddy's 3
com.scottgames.fnaf2	Five Nights at Freddy's 2
com.scottgames.fnaf4	Five Nights at Freddy's 4
com.scottgames.sisterlocation	Five Nights at Freddy's: SL
com.screenzterapp	Low-key
com.screwbar.gudakcamera	Gudak Cam
com.scribd.iscribd	Scribd - audiobooks & ebooks
com.sdpgames.sculptpeople	Sculpt people
com.secondline.message	Second Phone Number'
com.seekingalpha.SeekingAlpha	Seeking Alpha: News & Analysis
com.seekrtech.sleep	SleepTown
com.seekrtech.water	WaterDo
com.seenax.hide-and-seek	Hide 'N Seek!
com.sega.score	Football Manager 2021 Mobile
com.sega.sjump	Sonic Jump™
com.sega.sonic4	Sonic The Hedgehog 4™ Episode I
com.sega.sonicdash	Sonic Dash - Endless Running
com.sei.sherman	7-Eleven, Inc.
com.seizethedayo.chanvoc	Funny Voice Effects & Changer
com.selflender.thor	Self - Build Credit
com.sensi.BooksyBIZZ	Booksy Biz: Online Scheduling
com.sensi.BooksyCUST	Booksy: book your appointment
com.sensio.instapreview	Preview: Planner for Instagram
com.sensustech.rokuremote	Screen Mirroring - Roku Plus
com.sensustech.screenmirroringx	Screen Mirroring X: Smart View
com.sephora.sephoramobile	Sephora: Buy Makeup & Skincare
com.sergey-gerasimenko.EasyDocScan	ScanGuru: PDF - Scanner
com.servicemagic.servicemagicconsumer	Angi: Find Local Home Services
com.sesameworkshop.PottyTimeElmo	Potty Time with Elmo
com.sesameworkshop.cookiecalls	Cookie Calls
com.sesameworkshop.elmocallsapp	Elmo Calls
com.setgame.setmania	SET® Mania
com.sethusenthil.savetoker	SaveTok
com.setolabs.Cryptomator	Cryptomator
com.sevenacademy.busyshape	Busy Shapes
com.sgiggle.Tango	Tango - Go Live & Video Chat
com.sgn.cookiejam	Cookie Jam: Match 3 Games
com.sgn.cookiejamblast	Cookie Jam Blast™ Match 3 Game
com.sgn.familyguy	Family Guy Freakin Mobile Game
com.sgn.geniesandgems	Genies & Gems: Puzzle & Quests
com.sgn.pandapop	Bubble Shooter - Panda Pop!
com.shaadi.iphone	Shaadi.com: Matrimony App
com.shabzco.AstheticKit	aesthetic kit
com.shape.change	Jelly Shift - Obstacle Course
com.shazam.Shazam	Shazam: Music Discovery
com.shengp.stickermaker	Sticker Maker - WhatsLove
com.shepherdpressincapps.Wise-Words-for-Moms	Wise Words for Moms
com.shibbolethmeal.app	Shibboleth Journal App
com.shipt.shopper	Shipt Shopper: Shop for Pay
com.shoethegoose.CakeDoodle	Cake Doodle
com.shotzoom.GolfshotGPS	Golfshot Plus
com.shotzoom.TOURCaddie	Golfshot: Golf GPS + Caddie
com.showStickers.project	Bucket Stickers
com.showtime.standalone	SHOWTIME: TV, Movies and More
com.shred.shredlabs	SHRED: Home & Gym Workout
com.shuksansoft.radarusplus	NOAA SuperRes Radar US
com.shutterfly.ShutterflyUploader	Shutterfly: Cards & Gifts
com.sidelabs.Tulsa	Coffee Inc: Business Tycoon
com.signalrsa.lobolaapp	The lobola Calculator
com.signnow.signnow	signNow: pdf document signer
com.sillens.iShape	Lifesum: Diet & Macro Tracker
com.silvercrk.spades	Hardwood Spades Pro
com.silversingles.app	SilverSingles - Mature Dating
com.silviu.st7.BSC-Address-Tracker	Binance Smart Chain Explorer
com.simogo.yearwalk	Year Walk
com.simonandschuster.pimsleur.unified.ios	Pimsleur - Learn Language Fast
com.simplehabitapp.shrelease	Simple Habit Sleep, Meditation
com.simpletouch.TabataPro	Tabata Pro - Tabata Timer
com.simtrggp.callforfire	Call For Fire
com.simulationcurriculum.SkySafari6	SkySafari
com.simulationcurriculum.SkySafari6Pro	SkySafari 6 Pro
com.simvex.spacesimulator	Space Simulator
com.sincerely.ink	Ink Cards: Send Custom Cards
com.siriusxm.siriusxmonline	SiriusXM-Music, Comedy, Sports
com.sixdays.trust	Trust: Crypto & Bitcoin Wallet
com.sixflags.ios	Six Flags
com.sixmix.minder	Salams (Formerly Minder)
com.sixthcorner.PerfectCircle	Perfect Circle
com.sixwaves.cml	Call me a Legend
com.skhapps.ewtptoo	Emily Wants to Play Too
com.skillshare.Skillshare	Skillshare - Creative Classes
com.skout.SKOUT	Skout — Meet New People
com.skyfitsports.skyfit	Aaptiv: #1 Audio Fitness App
com.skyjos.fileexplorer	FE File Explorer Pro
com.skymoons.kittenmatch	Kitten Match
com.skype.skype	Skype for iPhone
com.slacker.radio	LiveXLive
com.slader.SladerReader	Slader Homework Answers
com.sleepmachine.pro	Sleep Machine
com.sleepyzstudios.skisafari2	Ski Safari 2
com.slema.BatteryPlus	Battery HD+ Pro
com.slime4fun.epicsimulator	Slime it: Slime Game Simulator
com.slippy.linerusher	Fun Race 3D
com.slothwerks.krumit	Meteorfall: Krumit's Tale
com.smallbeautiful.racerking	RacerKing - Get the Crown
com.smallbusinessvictory.SwingBySwing	Golf GPS SwingU
com.smallgiantgames.combat	Puzzle Combat: Match-3 RPG
com.smallgiantgames.empires	Empires & Puzzles Epic Match 3
com.smartestapple.50radiopro	5-0 Radio Pro Police Scanner
com.smartlens.ios	Smart Lens - AI Translate
com.smmservice.pdfeditor	PDF Editor ®
com.smmservice.printer	Printer App for AirPrint
com.smo.deepcleaninc3d	Deep Clean Inc. 3D
com.smo.extrahotchili3d	Extra Hot Chili 3D
com.smoothlandon.happycow	Vegan Food Near You - HappyCow
com.smule.minimagicpiano	Magic Piano by Smule
com.smule.sing	Smule: Social Karaoke Singing
com.snagajob.iphoneclient	Snagajob - Jobs Hiring Now
com.sneakerhubshop	Sneaker Hub Shop
com.snkplaymore.KOFi2012001	THE KING OF FIGHTERS-i 2012
com.snkplaymore.MS1	METAL SLUG 1
com.snkplaymore.MS3	METAL SLUG 3
com.snkplaymore.kof97	THE KING OF FIGHTERS '97
com.snkplaymore.kof98	THE KING OF FIGHTERS '98
com.snoregym.app	SnoreGym : Reduce Your Snoring
com.snowcorp.vita	VITA - Video Editor & Maker
com.snowman.alto	Alto's Adventure
com.snowman.altos-odyssey	Alto's Odyssey
com.socialchain.blockchainvault	Pi Network
com.socialdataservices.nimble	Curtsy — Thrifting, Delivered
com.sofarsogood.incredibox	Incredibox
com.softforcellc.VPNBoss	VPNBoss - Privacy & Security
com.softwarestudios.asldictionaryhdamericansignlanguage	ASL Dictionary Sign Language
com.solidworks.edrawings	eDrawings
com.solotrainerapp.solo	Solo - Fretboard Visualization
com.sonic.sonicdrivein	SONIC Drive-In
com.sonorancad	Sonoran CAD
com.sonos.SonosController2	Sonos
com.sonosaurus.TETuner	TonalEnergy Tuner & Metronome
com.sonypicturestelevision.wwtbam	Who Wants to Be a Millionaire?
com.soundcloud.TouchApp	SoundCloud - Music & Audio
com.southwest.iphoneprod	Southwest Airlines
com.sp0n.vigilante	Citizen: Connect and Stay Safe
com.spacecangames.juicyrealm	Juicy Realm
com.spacegab.slideshow	SlideShow Maker Photo to Video
com.spark.CM	Christian Mingle: Dating App
com.sparklingapps.translator	Translator with Speech Pro
com.special.warships	Battle Warship: Naval Empire
com.specialwishu.diirotefo	Super Likes Meme- Get Much Fun
com.specter.Sine-Graph	Spectra - Music Visualizer
com.sperrylabs.nightvision	LiDAR & Infrared Night Vision
com.spicerackmedia.bingoshowdown	Bingo Showdown -> Bingo Games!
com.spin.win.sfc	Spin for Cash - Win Big & Fast
com.spirit.customerapp	Spirit Airlines
com.spiritclips.sc	Hallmark Movies Now
com.sporcle.Sporcle	Sporcle
com.sports.real.golf.rival.3d	Golf Rival
com.sportsactioninc.action	Action Network Sports Betting
com.sportys.e6b	Sporty's E6B Flight Computer
com.spoten	Spoten: location tracker, GPS
com.spotify.client	Spotify: Discover new music
com.spotlightsix.progressivealarmclock	Progressive Alarm Clock
com.spotlightsix.zentimer	Insight Timer - Meditation App
com.spudpickles.GRConnect	Ghost Radar®: CONNECT
com.sqlwizards.vocular	Vocular
com.square-enix.DFFOperaOmnian	DISSIDIA FINAL FANTASY OO
com.square-enix.FinalFantasy	FINAL FANTASY
com.square-enix.FinalFantasy2	FINAL FANTASY II
com.square-enix.FinalFantasy4	FINAL FANTASY IV
com.square-enix.FinalFantasy6	FINAL FANTASY VI
com.square-enix.FinalFantasy8w	FINAL FANTASY VIII Remastered
com.square-enix.SaGaFrontierRemasteredww	SaGa Frontier Remastered
com.square-enix.WOTVffbeww	FFBE WAR OF THE VISIONS
com.square-enix.chronotrigger	CHRONO TRIGGER (Upgrade Ver.)
com.square-enix.ffbeww	FINAL FANTASY BRAVE EXVIUS
com.square-enix.fft	FINAL FANTASY TACTICS :WotL
com.square-enix.final-fantasy-vii-ww	FINAL FANTASY VII
com.squarecrowdapps.stamina	STAmina Apnea Trainer
com.squareenixmontreal.hitmansniper	Hitman Sniper
com.squareup.cash	Cash App
com.squareup.square	Square Point of Sale (POS)
com.srgstudios.inkinc	Ink Inc. - Tattoo Drawing
com.stadiumgoods.app	Stadium Goods
com.staplegames.solitaire	Solitaire (Classic Card Game)
com.star.ce5contact	CE5 Contact
com.starbucks.mystarbucks	Starbucks
com.stardock.tpm2020mobile	The Political Machine 2020
com.starmakerapp.starmaker	StarMaker-Sing Karaoke Songs
com.stary.amonovela	Suenovela
com.starz.starzplay	STARZ
com.stash.stash-invest	Stash: Invest & Build Wealth
com.statefarm.DriveSafeAndSave	Drive Safe & Save™
com.statefarm.mobile.iphone	State Farm®
com.stateofplaygames.luminocitygame	Lumino City
com.steady.steadyapp.com	Steady-Find Work. Earn Money.
com.steadystate.Sticky.Flip	Sticky Flip
com.steelcrategames.ios.keeptalkingandnobodyexplodes	Keep Talking & Nobody Explodes
com.steelwoolstudios.fnafhw	Five Nights at Freddy's: HW
com.step.step	Step - Teen Banking
com.stephangauch.BimmerDash	BimmerLink for BMW and MINI
com.steventopczewski.goodgrade	Good Grade
com.sticker.funchart	Fun chart stickers
com.stickman.warriors.stickwarriors.dragon.shadow.fight	Stickman Warriors Fight
com.stofledesigns.dicewithbuddiesfree	Dice With Buddies: Social Game
com.stoicstudio.BannerSaga	Banner Saga
com.stoneaxe.catchandshoot	Catch And Shoot
com.storm8.hdpropertybrothers	Property Brothers Home Design
com.stove.epic7.ios	Epic Seven
com.strava.stravaride	Strava: Run, Ride, Swim
com.streaksapp.streak	Streaks
com.streaksapp.streaks.workout	Streaks Workout
com.streamkar.streamkar	StreamKar - Live Video Chat
com.streamsidesoft.spiritstorybox	Spirit Story Box
com.stromdamage.RadarX	RadarOmega
com.stromming.Plants	Planta: Keep your plants alive
com.studiowildcard.wardrumstudios.ark	ARK: Survival Evolved
com.stx.pullhimout	Pull Him Out
com.subatomicstudios.Fieldrunners	Fieldrunners
com.subway.mobile.subwayapp03	Subway®
com.summersings.suntickerma	Stickers Funny of Meme & Emoji
com.sumoenterprises.anso	AnSo Anaesthesia Sonoanatomy
com.sumoing.ReColor	Recolor - Adult Coloring Book
com.sun.tinder	Tender: Creature Comforts
com.sunbird.birdsongid.america.ne	Bird Song Id USA songs & calls
com.sundancenow.docclub	Sundance Now: Exclusive Series
com.sundancenow.shudder	Shudder: Horror & Thrillers
com.sunmosh.usedcarsdealer	Used Cars Dealer-Car Sale Game
com.sunsurveyor.SunSurveyor	Sun Surveyor (Sun & Moon)
com.super-toki.giraffe	Like A Giraffe
com.superant.classicvegasslots	Slots - Classic Vegas Casino
com.superant.doublehitcasino	Double Hit Casino: Vegas Slots
com.superbox.ios.fire2048	Drop The Number : Merge Puzzle
com.supercell.laser	Brawl Stars
com.supercell.magic	Clash of Clans
com.supercell.reef	Boom Beach
com.supercell.scroll	Clash Royale
com.supercell.soil	Hay Day
com.superdhubt.ios	Super Dragon Heroes:Unbeatable
com.superimposeapp.superimposex	Superimpose X
com.superking.ludo.star	Ludo STAR
com.superking.parchisi.star	Parchisi STAR
com.supernova.shediao	新射鵰群俠傳之鐵血丹心
com.superplaystudios.dicedreams	Dice Dreams™
com.superprism.illusion	ILLUSION CONNECT
com.superthz.silhouetteStudio	Silhouette Photo Editor
com.surfline.surfapp	Surfline - Surfing Companion
com.sushirolls.game	Sushi Roll 3D - ASMR Food Game
com.swagmasha.dreamzone	Dream Zone: Interactive Story
com.swagmasha.genres	Love Sick: Interactive Stories
com.swiger.app	Sudy - Meet New People
com.swinglifestyle.ios	SLS Official Swinger Community
com.swirski.photo-booth-a7m3	Shutter - Sony Camera Remote
com.syf.mysynchrony	MySynchrony
com.symantec.mobilesecurity	Norton 360: Mobile Security
com.symantec.securewifi	Norton Secure VPN & Proxy VPN
com.symbolab.symbolab	Symbolab Calculator
com.synctuition.synctuition	Synctuition Mindspa Meditation
com.sypartners.superpowers	Superpowers by SYPartners
com.syubestgames.teachersimulator	Teacher Simulator
com.szckhd.jwgly.iosyw	Be The King: Judge Destiny
com.t11.celeste	SkyView®
com.t11.satellites	SkyView® Satellite Guide
com.t3securities.matador	Public - Invest in Stocks
com.tacobell.ARgame	Taco Bell - For Our Fans
com.tactustherapy.ApraxiaTherapy	Apraxia Therapy
com.tactustherapy.DysphagiaTherapy	Dysphagia Therapy
com.tagged.meetme	Tagged -Chill, Chat & Go Live!
com.tahquam.CountdownStar	Countdown Star (Ad-Free)
com.taimi.ios	Taimi: LGBTQ+ Dating, Chat
com.talkingparents.iphoneapp	TalkingParents
com.tangram3D.SummerGames	Summer Games 3D
com.tangram3d.AthleticsFull	Athletics: Summer Sports Full
com.tangramgames.wordcrush.ios	Word Crush - Fun Puzzle Game
com.tap4fun.brutalage.test	Brutal Age: Horde Invasion
com.tap4fun.kissofwar.appstore	Kiss of War
com.tap4fun.reignofwar	Invasion: Modern Empire
com.tapasmedia.Tapastic	Tapas – Comics and Novels
com.tapcart.EOxMRhMf2w	RIPNDIP
com.tapcart.npQt0DXZpj	Fashion Nova
com.tapgang.cheating	Catch Your Cheating Spouse: Spy Tools & Info 2017
com.tapgang.textures	Texture Packs & Creator for Minecraft PC: MCPedia
com.tapinator.videopokerclassic	Video Poker Classic ™
com.taplistic.cryptosignal	Cryptosignal
com.taplistic.stocksignal	Stocks Alerter
com.tapped.drawrider	Scribble Rider
com.tappingsolution	The Tapping Solution
com.tappytaps.Baby-Monitor-3G	Baby Monitor 3G
com.tappytaps.ios.dogmonitor	Dog Monitor
com.tappytoon.tappytoon	Tappytoon Comics & Webtoons
com.taptaptap.CameraPlus	Camera+ Legacy
com.taptopia.pixelmonguide	PIXELMON MOD - Pixelmon Mod Guide and Pokedex with installation instructions for Minecraft PC Edition
com.tarekmongy.RunofLife	Run of Life
com.target.Target	Target
com.tarushi.makeareceipt	Make a Receipt
com.tastypill.twistyarrow	Twisty Arrow!
com.tatemgames.carnivores	Carnivores:Dinosaur Hunter Pro
com.tatemgames.carnivoresiceage	Carnivores: Ice Age Pro
com.tayasui.talkingcarlmessenger	Talking Carl
com.tdameritrade.ism	TD Ameritrade Mobile
com.tdbank.iphoneapp	TD Bank (US)
com.teachyourmonstertoread.tm1	Teach Your Monster to Read
com.team17.escapists	The Escapists: Prison Escape
com.team17.sheltered	Sheltered
com.team17.worms3	Worms3
com.team17.worms4	Worms™ 4
com.teamlava.bakerystory	Bakery Story
com.teamn.wooplus	Dating, Meet Curvy - WooPlus
com.teamsnap.ios	TeamSnap
com.teamspeak.teamspeak	TeamSpeak 3
com.techvision.hotelcraze	Hotel Craze™: Hotel Game
com.teix.allinOne	Universal remote tv smart
com.tekstilooo.ethervpn	Ether VPN - Light and Secure
com.teltechcorp.scream	SpoofCard
com.ten.mtondemand	MotorTrend: Stream Car Shows
com.tencent.ig	PUBG MOBILE 3RD ANNIVERSARY
com.tencent.tmgp.sskeus	Saint Seiya Awakening
com.tencent.wecomic	WeComics
com.tencent.xin	WeChat
com.tensquaregames.hunting.clash.wild.hunter.deer	Hunting Clash: Hunter World
com.tensquaregames.letsfish2	Fishing Clash
com.teorex.inpaint-iphone	Inpaint
com.tetzfiles.XAirMonitorMixer	XAir Monitor Mixer
com.textmeinc.textme2	Text Me - Phone Call + Texting
com.tezzanyc.Tezza	Tezza: Aesthetic Photo Editor
com.tgame.girios	Girl Genius!
com.tgame.silhouetteartnew	Silhouette Art
com.tgc.sky.ios	Sky: Children of the Light
com.tgd.word	Word Trip: Explore Word World
com.thatsmystapler.erg	HazMat Reference
com.theathletic.news	The Athletic: Sports News
com.thecooldev.fueling-timer	Fueling Timer
com.thecut.mobile.ios.thecut	theCut: #1 Barber Booking App
com.theepochtimes.mobile	Epoch Times: Live & Breaking
com.thegrint.grint	TheGrint | Your Golferhood
com.thehomedepot.homedepot	The Home Depot
com.thehungrywasp.iamsober	I Am Sober
com.thelandofcolor.LRV-Guru	LRV Guru
com.themeborne.etdc	Escape the Dark Castle
com.theordinaryguide.app	Skincare Routine
com.theotino.bingo.luckybingowonderland	Bingo! Live Story Bingo Games
com.thepattern.thepattern	The Pattern
com.thepositivebirthcompany.surgetracker	Freya • Surge Timer
com.thermowatch.ThermoWatch	Thermo Watch for Nest & Ecobee
com.thetileapp.tile	Tile - Find lost keys & phone
com.theweatherforecastapp.weatherapp	The Weather Forecast App
com.thezeusnetwork.www	The Zeus Network
com.thisclicks.wheniwork	When I Work Staff Scheduling
com.thisexitllc.roadsideamerica	Roadside America
com.thomasnelson.jesuscalling	Jesus Calling Devotional
com.thredup.thredup	thredUP
com.thumbtack.bowtie	Thumbtack: Hire Service Pros
com.thup.MonkeyMath	Monkey Math School Sunshine
com.ticketmaster.ios.TicketmasterApp	Ticketmaster－Buy, Sell Tickets
com.tijo.opener.Opener	Opener ‒ open links in apps
com.tilemaster.puzzle.block.match	Tile Master - Classic Match
com.tiltingpoint.spongebob	SpongeBob: Krusty Cook-Off
com.time.warper	Warp Slider
com.timewarnercable.simulcast	Spectrum TV
com.tinginteractive.usms	TextNow: Call + Text Unlimited
com.tinrocket.inkmatic1	Olli by Tinrocket
com.tinrocket.waterlogue1	Waterlogue
com.tintash.nailsalon	Nail Salon 3D
com.tinybuildgames.helloneighbor	Hello Neighbor
com.tinybuildgames.helloneighbor.hideandseek	Hello Neighbor Hide & Seek
com.tinybyte.robytefreemium	Roku TV Remote Control: RoByte
com.tinyco.potter	Harry Potter: Hogwarts Mystery
com.tinyspeck.chatlyio	Slack
com.tinytouchtales.cardthief	Card Thief
com.tippytap.yoga	Couples Yoga
com.tipranks.app	TipRanks Stock Market Research
com.tipsworks.ios.pascalswager	Pascal's Wager
com.titan.cd.gb	Creative Destruction
com.tjbus.ios.en4399	Mega Heroes
com.tlive.madcat	Trovo - Live Stream & Games
com.tmobile.TMOAccess	T-Mobile
com.tmobile.tuesdays	T-Mobile Tuesdays
com.tmsoft.WhiteNoise	White Noise
com.tocaboca.hairsalon2	Toca Hair Salon 2
com.tocaboca.parentingbirthday	Toca Birthday Party
com.tocaboca.tocaafterschool	Toca Life: After School
com.tocaboca.tocaband	Toca Band
com.tocaboca.tocaboo	Toca Boo
com.tocaboca.tocabuilders	Toca Builders
com.tocaboca.tocacity	Toca Life: City
com.tocaboca.tocahairsalon3	Toca Hair Salon 3
com.tocaboca.tocahairsalon4	Toca Hair Salon 4
com.tocaboca.tocahospital	Toca Life: Hospital
com.tocaboca.tocakitchen2	Toca Kitchen 2
com.tocaboca.tocakitchensushi	Toca Kitchen Sushi
com.tocaboca.tocalab	Toca Lab: Elements
com.tocaboca.tocalabplants	Toca Lab: Plants
com.tocaboca.tocalifefarm	Toca Life: Farm
com.tocaboca.tocalifeworld	Toca Life World: Build stories
com.tocaboca.tocamini	Toca Mini
com.tocaboca.tocamysteryhouse	Toca Mystery House
com.tocaboca.tocanature	Toca Nature
com.tocaboca.tocaneighborhood	Toca Life: Neighborhood
com.tocaboca.tocaoffice	Toca Life: Office
com.tocaboca.tocapetdoctor	Toca Pet Doctor
com.tocaboca.tocapets	Toca Life: Pets
com.tocaboca.tocaschool	Toca Life: School
com.tocaboca.tocastable	Toca Life: Stable
com.tocaboca.tocatown	Toca Life: Town
com.tocaboca.tocavacation	Toca Life: Vacation
com.todyapp.tody	Tody
com.toktumi.LineTwo	Line2 - Second Phone Number
com.tomatamara.stickermaker	Sticker Maker Studio
com.tombrereton.imavlink.100	SidePilot
com.tommo.pp2-ien	Putt-Putt Goes to the Moon
com.toneitup.tiustudio	Tone It Up: Workout & Fitness
com.toomics.ios.global	Toomics - Unlimited Comics
com.top.next.vpn	ProVPN: Proxy VPN Master
com.topapp.si.myscans	My Scans, best PDF Scanner App
com.topfreegames.bikeracefree	Bike Race: Free Style Games
com.topfreegames.bikeracepaid	Bike Race Pro: Motor Racing
com.topgamesinc.evony	Evony
com.tophatter.tophatter	Tophatter: Win Fun Discounts
com.topps.bunt	Topps® BUNT® MLB Card Trader
com.topps.force	Star Wars Card Trader by Topps
com.topps.marvel	Marvel Collect! by Topps
com.topultragame.slotlasvega	Cash Tornado Slots - Casino
com.torpedolabs.wynn.slots	Wynn Slots - Las Vegas Casino
com.touchmint.baseballpitchspeedtouch	Baseball Pitch Speed - Radar Gun
com.touchtunes.mytouchtunesRD	TouchTunes
com.toycartools.recipegallery	Recipe Gallery
com.toyopagroup.picaboo	Snapchat
com.toyota.OneApp	Toyota
com.tp.moneybank	Money Bank 3D!
com.tracfone.Straight-Talk-Wireless-My-Account	Straight Talk My Account
com.tracygates.surgicalinstrumentation	Surgical Instrumentation
com.tradingview.tradingviewapp	TradingView - Stocks & Forex
com.tradlessons.pocketbox	Hohner Mini-SqueezeBox
com.trail.game	Sky Trail
com.trailbehind.GaiaGPS.ng	Gaia GPS Hiking, Offroad Maps
com.trailofbits.iverify2	iVerify. - Secure your Phone!
com.translationunited.unitedmasters	UnitedMasters
com.treemengames.pako2	PAKO 2
com.trianglepixel.clashcaddie	Clash Caddie
com.triller.projectx	Triller: Social Videos & Clips
com.trimhealthymama.journey.app	Trim Healthy Mama Journey
com.trinitigames.warconquer	War & Conquer
com.tripadvisor.LocalPicks	Tripadvisor: Plan & Book Trips
com.tripledot.blackjack	Blackjack
com.tripledot.solitaire	Solitaire
com.tripledot.woodoku	Woodoku
com.triplens.ios	Snap & Translate - Triplens
com.trivia.star.ios	Trivia Star: Trivia Games Quiz
com.tropicalsmoothiecafe.app	Tropical Smoothie Cafe
com.trpz.travel	Match To Win: Cash Giveaway
com.trsgames.spinthewheelapp	Spin The Wheel - Random Picker
com.trueaxis.skate	True Skate
com.truebill.truebillnative	Truebill Budget & Bill Tracker
com.truesoftware.TrueCallerOther	Truecaller
com.trulia.Trulia	Trulia Real Estate: Find Homes
com.trydave.dave	Dave - Banking for humans
com.tsheets.greatwhite.TSheets	QuickBooks Time Tracker
com.tsmart.wifivpn	Wi‎‎‎‎‎‎‎‎‎‎FiHi‎‎‎‎de‎‎ VP‎‎N
com.ttlike.mbsaen.ios	Bleach: Immortal Soul
com.ttt.ios.tracker	Followers Track for Instagramº
com.tumblr.tumblr	Tumblr - Home of Fandom
com.tummygames.sliceit	Slice It All!
com.tunein.TuneInRadio	TuneIn Radio: Music & Sports
com.tunnelbear.ios.TunnelBear	TunnelBear: Secure VPN & Wifi
com.turbo.stars	Turbo Stars
com.turbomonad.galag4	Galax Defender
com.turborilla.MadSkillsMotocross2	Mad Skills Motocross 2
com.turner.b10runner	Ben 10: Up to Speed
com.turner.stevenrpg	Attack the Light
com.turner.ttgfigures	Teeny Titans - Teen Titans Go!
com.turner.ttgfigures2	Teen Titans Go! Figure
com.tvcast.chromecast	TV Cast for Chromecast TV App
com.tvcast.firetv	Fire App - Fire Stick Remote
com.tvcast.rokuremote	Roku Remote Control - Roki
com.tvcast.screenmirror	Screen Mirroring - TV Cast
com.tvcast.smartthings	Smart Things: Smart View App
com.tvcast.vizcontrol	Vizo Remote: Smartcast TV App
com.tw.tycoon.casino	Tycoon Casino™ - Vegas Slots
com.two31play.mahjongcity	Mahjong+
com.twodesperados.violasquest	Viola’s Quest: Marble Blast
com.twodestudios.dodgemaster	Dodge Master!
com.twostepsbeyond.public-lands	US Public Lands
com.twoxlgames.mxmatchuppro	Ricky Carmichael's Motocross Matchup Pro
com.ubercab.UberClient	Uber - Request a ride
com.ubercab.UberEats	Uber Eats: Food Delivery
com.ubercab.UberPartner	Uber Driver
com.ubisoft.assassin.identity	Assassin's Creed Identity
com.ubisoft.brawl.halla.platform.fighting.action.pvp	Brawlhalla
com.ubisoft.dance.JustDance	Just Dance Now
com.ubisoft.dragonfire	South Park: Phone Destroyer™
com.ubisoft.hungrysharkworld	Hungry Shark World
com.udates.ios	uDates Local Dating: Chat Date
com.udemy	Udemy Online Video Courses
com.ufc.UFCTV	UFC
com.uken.BingoPop	Bingo Pop - Live Bingo Games
com.uken.solitaire.story	Ava's Manor: A Solitaire Story
com.ulta.UltaMcommerceApp	Ulta Beauty: Makeup & Skincare
com.ultimateguitar.tabs100	Ultimate Guitar: Chords & Tabs
com.ultimatesoftware.ultipromobile	UKG Pro (UltiPro)
com.ultraandre.pccreatorpro	PC Creator PRO
com.ultrahuman.ios	Ultrahuman: Workout & Sleep
com.ultrasoftwaresolutions.GearSpeed	Gear Speed - Brushless RC Speed Calculator
com.umi.feudlive	Family Feud® Live!
com.uncosoft.highheels	High Heels!
com.uncutaudio.autotan	AutoTan
com.underwoodapps.Circuit	Circuit Route Planner
com.unicornapps.Black	Black - Live Wallpapers
com.unicostudio.braintest	Brain Test: Tricky Puzzles
com.unicostudio.braintest2	Brain Test 2: Tricky Stories
com.unicostudio.whois	Who is? Brain Teaser & Riddles
com.united.UnitedCustomerFacingIPhone	United Airlines
com.universalis.universalis	Universalis
com.univision.prendetv	PrendeTV: TV In Spanish
com.univision.univisionnow	Univision Now
com.unwite.onthemap	Find my Phone, Friends - iMapp
com.uo.StoreLocator	Urban Outfitters
com.upallnitesoftware.walkoutsongdj	Walkout Song DJ
com.upasani.iTablaPro	iTablaPro
com.uphold.wallet.ios	Uphold: buy and sell Bitcoin
com.upjers.zoo2animalpark	Zoo 2: Animal Park
com.uplandme.app	Upland - Property Trading Game
com.uplayonline.esportslifetycoon	Esports Life Tycoon
com.uplayonline.youtubers	Youtubers Life: Gaming Channel
com.uplayonline.youtubersmusic	Youtubers Life - Music
com.uppertierdevelopment.rangerschoolpro	Ranger School Professional
com.ups.m.iphone	UPS Mobile
com.upside-services.consumer	GetUpside Cashback: Gas & Food
com.upwlabs.emma	Glow Period, Fertility Tracker
com.uqxuwtxbbu.parkingjam	Parking Jam 3D
com.urbn-pockets.Anatomy	My Body - Anatomy for Kids
com.uread.novel	Uread
com.usaa.UsaaMobile	USAA Mobile
com.usablenet.walgreens	Walgreens
com.usbank.icmobilebanking	U.S. Bank
com.usman.huntfish	3D Fish Feeding and Grow
com.usps.uspsmobile	USPS Mobile®
com.ustwo.monumentvalley	Monument Valley
com.ustwo.monumentvalley2	Monument Valley 2
com.utincomputer.hyperovertake	Rush Hour 3D
com.vacation.countdown.app	Countdown
com.valvesoftware.Steam	Steam Mobile
com.vargo.coex	Coexisting Diseases & Surgery
com.varomoney.VaroBank	Varo Bank: Mobile Banking
com.vblast.flipaclip	FlipaClip: Create 2D Animation
com.veamstudios.iaudit	Site Audit Pro
com.vectorunit.red	Riptide GP2
com.vectorvest.mango	VectorVest Stock Advisory
com.vegas.casino.slots.game	Vegas Casino Slots - Mega Win
com.veraniz.lite	mSpy: Find my Friends Phone
com.verisign.mvip.iphone	VIP Access for iPhone
com.verticalbrands.apartmentlist	Apartment List
com.vertigo.shoottracer	Shot Tracer
com.verv.app	Verv: Home Fitness Workout
com.vettv	VET Tv
com.vfs.vibrator	Vibrator ·
com.vhx.worldofwonder	WOW Presents Plus
com.viber	Viber Messenger: Chats & Calls
com.vibrate.vibratingapp	Vibrator ~
com.victoriassecret.pinknation	PINK Nation
com.videochat.olive	Olive - Live Video Chat App
com.vigorapps.30DayFitness	30 Day Fitness - Home Workout
com.viki.viki-ios	Viki: Asian Drama, Movies & TV
com.vilcsak.bitcoin2	Coinbase – Buy & sell Bitcoin
com.vimeo.vimeocreate	Vimeo Create - Video Editor
com.vinnov.Live-Wallpapers	Live Wallpapers & Backgrounds+
com.visualhype.pedometer	Stepz - Step Counter & Tracker
com.visualvertigo.argolf	Putt Vision
com.vitotechnology.StarWalk2	Star Walk 2: The Night Sky Map
com.vixerapp.Vixer	Vixer – Video Editor & Maker
com.viz.iphone-manga	VIZ Manga – Direct from Japan
com.viz.wsj	Shonen Jump Manga & Comics
com.vizio.SmartCast	VIZIO SmartCast Mobile™
com.vizor-apps.Atlantis	Atlantis Odyssey
com.vizor-apps.Klondike	Klondike Adventures: Farm Game
com.vizor-apps.Mahjong	Mahjong Treasure Quest
com.vladk.pipemasters	Flow Legends
com.vlambeer.ridfishing	Ridiculous Fishing - A Tale of Redemption
com.vlbapps.wizz	Wizz - Make new friends
com.vocabulary.app	Vocabulary.com
com.voicedream.Voice-Dream-Reader	Voice Dream Reader
com.volunteerspot.mobile	Sign Up by SignUp.com
com.vpn.guardize	GUARDIZE
com.vpnbanana.wingy	Wingy - Http(s) Socks5 Proxy Utility
com.vrbo.traveler	Vrbo Vacation Rentals
com.vs.VeinSeekPro	VeinSeek Pro
com.vsallaccess.allaccess	Victoria’s Secret
com.vudu.VuduIosClient	Vudu - Movies & TV
com.vzw.VZ-Transfer	Verizon Content-Transfer
com.vzw.hss.myverizon	My Verizon
com.wakingup.wakingup	Waking Up: Guided Meditation
com.waldenback.driverlicenseapp	DMV Practice Test by Zutobi
com.wallpaper.customlive	Live Wallpaper 4K & Icon Theme
com.wallpapershub.anime	Anime & Wallpapers
com.walmart.electronics	Walmart - Shopping & Grocery
com.walmart.squiggly	Me@Walmart
com.waplog	Waplog Dating App- Meet Now
com.warbyparker.app	Warby Parker
com.wartoft.seterra	Seterra Geography (full)
com.washingtonpost.Rainbow	Washington Post Select
com.waterminder.waterminder	WaterMinder®
com.wave.livewallpaper	Live Wallpapers & Lockscreens
com.wawa.wawaapp	Wawa
com.wayfair.WayfairApp	Wayfair – Shop All Things Home
com.waze.iphone	Waze Navigation & Live Traffic
com.wb.Ellen.HeadsUp	Heads Up!
com.wb.GoT.Conquest	Game of Thrones: Conquest ™
com.wb.HeadsUpPictures	Heads Up! Kids
com.wb.Injustice.Brawler2013	Injustice: Gods Among Us
com.wb.Injustice.Brawler2017	Injustice 2
com.wb.LEGOBatman2	LEGO Batman: DC Super Heroes
com.wb.LEGOJurassicWorld	LEGO® Jurassic World™
com.wb.LEGOMarvel	LEGO® Marvel Super Heroes
com.wb.LNJGO	LEGO® Ninjago™
com.wb.MK.Brawler2015	Mortal Kombat
com.wb.Scribblenauts	Scribblenauts Remix
com.wb.dc.legends	DC Legends: Fight Superheroes
com.wb.dcuniverse	DC UNIVERSE INFINITE
com.wb.lbbg	LEGO® Batman™: Beyond Gotham
com.wb.scribblenauts3	Scribblenauts Unlimited
com.wcj5x2app.ExporterPDFLitever	Message SMS Export to PDF,XLS
com.wdwaxeneoboard.com	Netboom Game
com.weareempire.BMDBluetoothControl	Bluetooth+ for Blackmagic
com.weareloup.hco	Centr, by Chris Hemsworth
com.weather.TWC	Weather - The Weather Channel
com.weatherradarforecastlive.radar	NOAA Radar & Weather Forecast
com.webSeller.Anomity	Upcure
com.weber.shield	Prime Shield: online security
com.webex.meeting	Cisco Webex Meetings
com.webnovel.reader	Webnovel - Fictions & Comics
com.webull.trade	Webull: Investing & Trading
com.wecut.dressupgirl	Pinky Girl: Dress up & Fashion
com.wecut.staridol	Star Idol:3D Avatar Creator
com.wedobest.numpush	Numpuz: Number Puzzle Games
com.weedmaps.WeedMaps	Weedmaps: Cannabis, Weed & CBD
com.weegoon.thiefpuzzle	Thief Puzzle: to pass a level
com.weieyu.yalla	Yalla - Group Voice Chat Rooms
com.weightlossrunapp	Run & Walk to lose weight
com.weightwatchers.wwmobile	WW Weight Watchers Reimagined
com.wendys.NutritionTool	Wendy’s
com.weplaydots.twodots	Two Dots
com.westbund.taptapheroes	Taptap Heroes:Void Cage
com.westernunion.mtapp	Western Union: Transfer Money
com.wf.mobilebanking	Wells Fargo Mobile
com.wftllc.blackjack-strategy	Blackjack Strategy Practice
com.wgames.en.neverlandcasino	Neverland Casino - Slots Games
com.wgt.golf	WGT Golf
com.wheresgeorge.wgapp	WheresGeorge.com Official App
com.whitepages.callerid	Hiya: Spam Phone Call Blocker
com.whitepages.mobile	Whitepages People Search
com.whitepages.mrnumber	Mr. Number Lookup & Call Block
com.whiteroom.crazydelivery	Crash Delivery: car jumping
com.whitewhalesoft.game-RubiksCube	3D Rubik's Cube Solver
com.whizpool.ezywatermark	eZy Watermark Photos
com.whosampled.whosampled	WhoSampled
com.wikr.walking	WalkFit Walking Cardio Fitness
com.wildbeep.dribblehoops	Dribble Hoops
com.wildlifestudios.suspects	Suspects: Mystery Mansion
com.williamsinteractive.goldfish	Gold Fish Casino Slots Games
com.williamsinteractive.hotshot	Hot Shot Casino Slots Games
com.williamsinteractive.jackpotparty	Jackpot Party - Casino Slots
com.windoweduniverse.dirtracingmobile3d	Dirt Racing Mobile 3D
com.windscribe	Windscribe VPN
com.winnersclub.e88s	Lucky Time Slots™ Vegas Casino
com.wix.admin	Wix Owner: Websites & Apps
com.wix.ios	Spaces: Follow Businesses
com.wizards.mtga	Magic: The Gathering Arena
com.wlling.tapaquarium	Insaquarium: Tap Aquarium
com.wolframalpha.wolframalpha	WolframAlpha
com.wombatapps.carbtracker	Carb Manager: Keto Diet App
com.womboai.wombo	WOMBO
com.wondergames.warpath.ios	Warpath
com.wonderpeople.megahitpoker.global	Mega Hit Poker: Texas Holdem
com.word.wordconnect	Word Connect ¤
com.wordgame.cross.ios.en	Word Calm - crossword puzzle
com.wordgame.newcross.ios.en	Word Craze - Trivia crosswords
com.wordsearch.wordsearch	Word Search Pro‧
com.workday.workdayapp	Workday
com.worldwings.iapp.navrules	NavRules
com.wow.wings	Elytra & Wings Addon Creator for Minecraft PC
com.ws.Alive	Alive by Whitney Simmons
com.wscreativity.toxx	Toxx-可爱治愈的心情日记本·便签本·手帐
com.wsy.wansuiye.en	Call Me Emperor-AlternateWorld
com.wtfapps.apollo16	BitLife
com.wwcall	SMS & Flash Call - WWCall
com.xd.musedash	Muse Dash 喵斯快跑-跑酷游戏
com.xdg.ios.wll	Ulala: Idle Adventure
com.xfinity.digitalhome	Xfinity
com.xiaoyi.yihome.tw	YI Home
com.xigmaGames.thebonfire2	The Bonfire 2 Uncharted Shores
com.ximad.puzzlesmagic	Magic Jigsaw Puzzles - Game HD
com.xinmei365.NewEmojiKey	Kika Keyboard for iPhone, iPad
com.xlegend.dragonicle.global	Dragonicle
com.xmgame.icingonthedress	Icing On The Dress
com.xmgame.savethegirl	Save The Girl!
com.xoom.app	Xoom Money Transfer
com.xpcapital.Celebs	Celebs - Celebrity Look Alike
com.xplicit.ultimatecaraudioapp	Ultimate Car Audio App
com.xunlegame.ysl.guanfang.ios	Spirit Beast of the East
com.xvpn	X-VPN - Best VPN Proxy master
com.xwavesoft.pomodoro	Be Focused Pro - Focus Timer
com.yahoo.Aerogram	Yahoo Mail - Organized Email
com.yakov.enigma	Enigma Toolbox
com.yalla.yallagame	Yalla Ludo - Ludo&Domino
com.yardi.rentcafe.resident	RENTCafe Resident
com.yaymedialabs.putong	Tantan
com.yeahus.trailbossbmx	Trail Boss BMX
com.yelp.yelpiphone	Yelp Food, Delivery & Services
com.yesteqlimited.artisy	Artisy-Photo Editor&Wallpapers
com.yoga-go	Yoga-Go: Yoga For Weight Loss
com.yogaglo.main	Glo | Yoga and Meditation App
com.yojoy.footclinic	Foot Clinic - ASMR Feet Care
com.yomob.yyzy	Night of the Full Moon
com.yoozoogames.fwgame	Forsaken World:Gods and Demons
com.yorfstudio.zescape	Z Escape
com.yoteware.sendtoscreen.fire.tv	SendToScreen for Fire TV
com.yottagames.gameofmafia	The Grand Mafia
com.yottagames.mafiawar	Mafia City: War of Underworld
com.yottagames.stoneage	Chief Almighty
com.youdagames.gop3multiplayer	Governor of Poker 3 - Friends
com.youneedabudget.evergreen.YNAB-Evergreen	YNAB (You Need A Budget)
com.younghorses.Octodad-Dadliest-Catch	Octodad: Dadliest Catch
com.younow.YouNowMobile	YouNow: Live Stream & Go Live
com.yourcompany.Carpenter	iHandy Carpenter
com.yourcompany.Clinometer	Clinometer + bubble level
com.yourcompany.DoodleJump	Doodle Jump
com.yourcompany.MortgagePC	Mortgage Calculator Pro
com.yourcompany.PPClient	PayPal: Mobile Cash
com.yourcompany.SunSeeker	Sun Seeker - Tracker & Compass
com.yourcompany.TestWithCustomTabs	AccuWeather: Weather Alerts
com.yourcompany.iBend-Pipe	iBend Pipe
com.yousician.yousician	Yousician - Your Music Teacher
com.youthhr.Phonto	Phonto - Text on Photos
com.ytzong.Instafollowers	nFollowers
com.yunatechnology.awesomecalendar	Awesome Calendar
com.yunyi.smartcamera	YI IoT
com.yurivish.Sapphire	Silk 2 – Generative Art
com.ywwebfic.webficnovel	Webfic
com.zaful.Zaful	ZAFUL - My Fashion Story
com.zaiadesign.maplets	Maplets – The Offline Maps App
com.zaidss.wrzone	WARZONE
com.zakg.scaryteacher.hellgame	Scary Teacher 3D
com.zareda.FlourishS	Christian Dating - Flourish
com.zedsaid.geocaching	Cachly - Geocaching
com.zeebagames.hairrush	Hair Rush
com.zeliogames.computer	Idle Streamer!
com.zenga.mypatience	Color Me Happy!
com.zenlife.home.blast	My Story - Mansion Makeover
com.zenstudios.starwarspinball	Star Wars™ Pinball 7
com.zentertain.homedesign	My Home - Design Dreams
com.zeptolab.bulletecho	Bullet Echo
com.zeptolab.cats	CATS: Crash Arena Turbo Stars
com.zerosum.barista3d	Barista Life
com.zhangyue.read.storyroom	Storyroom - Webnovel & Story
com.zhangyue.read.storytube	Story Lite - Completed Story
com.zhangyue.zyiReader.Thailand	iReader-Story, Novel & E-book
com.zhangyun.bravo	Bravonovel-Fictions&Webnovels
com.zhijiantiaodong.jiezoukupao	Beat Blade: Dash Dance
com.zhiliaoapp.musically	TikTok
com.ziconic.aircoasterxl	AirCoaster
com.zigzagame.evertale	Evertale
com.zillow.ZillowMap	Zillow Real Estate & Rentals
com.zillow.rentals	Zillow Rentals
com.zimride.instant	Lyft
com.ziprecruiter.jobs	ZipRecruiter Job Search
com.zjcgame.superdress	Yes, that dress!
com.zloong.eu.dr	Dragon Raja
com.zmangames.f2z.pandemic-ios	Pandemic: The Board Game
com.zmodo.Zmodo	Zmodo
com.zodiacpsychics.messenger	Zodiac Touch - psychic reading
com.zoosk.Zoosk	Zoosk International Dating App
com.zuletteran.scannerfree	Scanner App: PDF Document Scan
com.zulily.ios	Zulily
com.zuuks.bus.simulator.ultimate	Bus Simulator : Ultimate
com.zwift.ZwiftGame	Zwift: Ride and Run
com.zynga.FarmVille2CountryEscape	FarmVille 2: Country Escape
com.zynga.FarmVilleTropicEscape	FarmVille 2: Tropic Escape
com.zynga.WordsWithFriends3	Words With Friends 2 Word Game
com.zynga.gotslots	Game of Thrones Slots Casino
com.zynga.hititrich	Hit it Rich! Lucky Vegas Slot
com.zynga.livepoker.700	Zynga Poker - Texas Holdem
com.zynga.ozmatch	The Wizard of Oz Magic Match 3
com.zynga.pottermatch	Harry Potter: Puzzles & Spells
com.zynga.wizardofoz	Wizard of Oz: Casino Slots
com.zynga.wonka	Willy Wonka Slots Vegas Casino
com.zynga.wonkamatch	Wonka's World of Candy Match 3
coverage	Coverage?
crumbl.cookies	Crumbl Cookies
dayr	Day R Premium: last world war
de.2kit.Screen-Mirroring	TV Mirror+ for Chromecast
de.2kit.Screen-Mirroring-Browser	Screen Mirroring+ App
de.2kit.Screen-Mirroring-FireTV	Screen Mirroring+ for Fire TV
de.2kit.Screen-Mirroring-Roku	Screen Mirroring+ for Roku
de.2kit.cast-browser-firetv-pro	Video & TV Cast + Fire TV App
de.2kit.cast-browser-nexus-player-pro	Video & TV Cast + Google Cast
de.2kit.cast-browser-pro	Video & TV Cast + Chromecast
de.2kit.cast-browser-roku-pro	Video & TV Cast + Roku Player
de.2kit.cast-browser-sony-pro	Video & TV Cast Pro for Sony
de.BodyFast.BodyFast2	BodyFast Intermittent Fasting
de.affinitas.com.elitesingles.app	EliteSingles - Serious Dating
de.apploft.imicroscope	iMicroscope - Magnifying Glass
de.brettspielwelt.cartographers	Cartographers
de.christianhengst.circleoffifths	TONALY: Write & practice music
de.creating-your-app.NetToolbox	Network Toolbox Net security
de.credner.Histamin	Food Intolerances
de.esa.graphingcalculatortipro	TI 84 Graphing Calculator Man.
de.fastic.app	Fastic - Fasting App
de.neptune	Neptune - Antivirus & Analysis
de.stefanpledl.localcast	LocalCast for Chromecast
de.xan-applications.WristBook	WristWeb for Facebook
dev.grelice.bublvpn	Secure & Fast VPN Protector
developer.apple.wwdc-Release	Apple Developer
diewithme	Die With Me
disneydigitalbooks.dontletpigeonrunthisapp	Don't Let Pigeon Run This App!
dj.edu	DJ it! - Music Mixer Pad
dk.kimhansen.WatchForTesla	Watch app for Tesla
dk.letsoftware.MariasLifeTheBeginning	Sexy Maria
dk.tactile.lilysgarden	Lily’s Garden: Design & Relax
dk.tactile.mansionstory	Penny & Flo: Finding Home
doge.org.freewallet.app	Dogecoin Wallet by Freewallet
doordash.DoorDashConsumer	DoorDash - Food Delivery
dr2c.rocketcat.com	Death Road to Canada
droidhang.twgame.restaurant	animal restaurant
droom.sleepIfUCanFree	Loud Morning Alarm - Alarmy
ed.solutions.adblockforsafari	AdBlock for Safari VPN Browser
edu.stanford.naous.Addchat	Addchat - Random Chat
edu.wittenberg.music.kazez.InTune	InTune – Tuning Practice
emoto.iFacialMocap	iFacialMocap
en.co.a-tm.unison	Unison League
en.lrgame.sr.ios.sa	Stella Arcana- Eternal Stars
en.phoenix.game.ios.pr	Palace Rule
es.monkimun.lingokids	Lingokids - playlearning™
es.socialpoint.MonsterCity	Monster Legends: Collect all
es.socialpoint.dragoncity	Dragon City Mobile
es.socialpoint.wordlife	Word Life - Crossword puzzle
eu.bandainamcoent.verylittlenightmares	Very Little Nightmares
eu.gowod	GOWOD
eu.nordeus.TopEleven	Top Eleven Be a Soccer Manager
evolly.app.mirror	Screen Mirroring Z - Miracast
evolly.app.rokuremote	TV Remote - Universal Control
exodus-movement.exodus	Exodus: Crypto Bitcoin Wallet
fi.reworks.redecor	Redecor - Home Design Makeover
fitnessworkout.app	Fitness Coach
fl.fonts	WidgetBox: Widgets for iPhone
fl.productivity.app	HabitBox: Challenges & Habits
fonts.app	Fonts Art - Fonts for iPhones
fontskeyboard.fonts	Fonts
free.music.downloader	Music Downloader & Player
game.block.puzzles.iq	BlockPuz - Block Puzzles Games
game.puzzle.block.sudoku	Block Puzzle - Woody 99 202‪0
game.puzzle.woodypuzzle	Woody Block Puzzle Brain Game
games.ace.prisonlife	Prison Life!
games.elia.logosound	Jingle Quiz: Logo sound game
games.gungang	Gun Gang
games.lightheart.mrautofire	Mr Autofire
games.onebutton.golfbattle	Golf Battle
gbtf.EasyMSR	EasyMSR
gdprt.AdBlockPro	Privex Defender
gemini.Filmmaker-Pro	Filmmaker Pro - Video Editor
gemini.ProCam-2	ProCam 8
gen.tech.BetterMe	BetterMe: Home Workouts & Diet
gen.tech.impulse	Impulse - Brain Training
gen.tech.keiki.world	Keiki Puzzle Games for Toddler
gen.tech.yoursmartkid	Keiki Preschool Learning Games
genesis.tenwords	Words Booster: Learn Languages
gg.sunday.catescape	Cat Escape!
gmem.episode	My Fantasy: Make Your Story
gov.irs.IRS2Go	IRS2Go
gov.nasa.NASA	NASA
gov.ny.its.healthpassport.wallet	NYS Excelsior Pass Wallet
guitar.lite	Guitar - Games, Tabs & Chords
happy.blazeofbattle	Blaze of Battle
health.sleep.sounds.tracker.alarm.calm	ShutEye: Sleep Tracker, Sounds
hltek.YaoYao	YaoYao - Jump Rope
hr.apps.fashionbomb	Fashionbombdaily
huff.dean.twelvesteps	12 Steps Companion AA Big Book
iDeC.SteveWidget	Steve - Widget Game
iSelectApps.FunnyShapesFull	Smart Baby Shapes: Learning games for toddler kids
iSelectApps.SmartBabyABC	Smart Baby ABC Games: Toddler Kids Learning Apps
iSelectApps.SmartBabyGames	Smart Baby Sorter HD - Early Learning Shapes and Colors / Matching and Educational Games for Preschool Kids
iSelectApps.SmartRattlePaid	Smart Baby Rattle: Infant & Toddler Learning Games
idoser.com	iDoser Premium
ie.xemsoft.ScorePlayer	Sheet Music Scanner
ifax.pr	Fax from iPhone - Send Fax App
ifind.maps.gps.find.friends.family	Find My Phone, Friends&Family
ifitness.app	HitFit - At Home Workouts
ilmfinity.evocreo.main.IOSLauncher	EvoCreo™ - Pocket Monster RPG
im.kumu.ph	kumu - Live Videos and Games
im.talkme.talkmeim	Talkatone: WiFi Text & Calls
imgurmobile	Imgur - Funny Meme & GIF Maker
in.loop.hdmakeover	Home Design Makeover
in.playsimple.tripcross	Crossword Jam: Puzzles & Games
in.startv.hotstar	Hotstar- Live Cricket & Movies
inc.speramus.ios.crew	Crew Messaging and Scheduling
info.wearehere.distressedfxplus	Distressed FX : Plus
io.anuke.mindustry	Mindustry
io.blackcandy.archersio	Archers.io
io.coinCap.coinCap	CoinCap
io.comico	Pocket Comics: Premium Webtoon
io.dotcoding.software.FontsA	DaFont - Cool fonts
io.dwellapp.dwell	Dwell: Audio Bible
io.emergentstudios.linerider	Line Rider
io.faceapp.ios	FaceApp - AI Face Editor
io.fitplan.momentus.1	Fitplan: Gym & Home Workout
io.highcore.stealthmaster	Stealth Master: Assassin Ninja
io.metamask.MetaMask	MetaMask - Blockchain Wallet
io.oddworks.levintv	BlazeTV: Pro-America
io.radio.prime	radio.net PRIME
io.routeapp.route	Route: Order & Package Tracker
io.shakd.Hashtag-Genius	Hashtag Expert
io.state.fight	State.io - Conquer the World
io.the-wall.the-wall	Divar
io.townsend.obs-iphone	Camera for OBS Studio
io.voodoo.crowdcity	Crowd City
io.voodoo.paper2	Paper.io 2
io.voodoo.paper3	Paper.io 3D
ios.myketo.app	Keto Diet App - Macro Tracker
irlapp.com.IRL	IRL - Do More Together
is.abide.abide	Abide Bible & Sleep Meditation
it.rortos.realflightsimulator	RFS - Real Flight Simulator
jp.co.atm.vcon.ww	VALKYRIE CONNECT
jp.co.bandainamcoent.BNEI0297	ONE PIECE Bounty Rush
jp.co.bandainamcoent.BNEI0306	NARUTO X BORUTO NINJA VOLTAGE
jp.co.bandainamcoent.BNEI0334	DRAGON BALL LEGENDS
jp.co.bandainamcoent.BNEI0351	GUNDAM BATTLE: GUNPLA WARFARE
jp.co.bandainamcoent.BNEI0375	NARUTO X BORUTO NINJA TRIBES
jp.co.bandainamcogames.BNGI0218	ONE PIECE TREASURE CRUISE
jp.co.bandainamcogames.BNGI0221	DRAGON BALL Z DOKKAN BATTLE
jp.co.canon.bsd.iphone.PIXMA-Print	Canon PRINT Inkjet/SELPHY
jp.co.capcom.gyakusai4en	Apollo Justice Ace Attorney
jp.co.capcom.kenji1en	Ace Attorney INVESTIGATIONS
jp.co.capcom.mhsspen	Monster Hunter Stories
jp.co.capcom.rockmanxus	MEGA MAN X
jp.co.capcom.sf4cewd	Street Fighter IV CE
jp.co.goodroid.hyper.laser	Laser Beam 3D - drawing puzzle
jp.co.japantimes.genkiconj	GENKI Conjugation Cards
jp.co.ponos.battlecatsen	The Battle Cats
jp.co.spike-chunsoft.DR1	Danganronpa: Trigger Happy Hav
jp.co.spike-chunsoft.DR2.us	Danganronpa 2: Goodbye Despair
jp.co.taito.bustamovepremium	BUST-A-MOVE JOURNEY
jp.gocro.SmartNews	SmartNews: Local Breaking News
jp.goodsmile.grandsummonersglobal	Grand Summoners
jp.gungho.padEN	Puzzle & Dragons (English)
jp.konami.epjCastlevania2	Castlevania: SotN
jp.konami.pesactionmobile	eFootball PES 2021
jp.konami.yugiohmobile	Yu-Gi-Oh! Duel Links
jp.naver.lineplay	LINE PLAY - Our Avatar World
jp.ne.ibis.ibisPaint	ibis Paint
jp.ne.ibis.ibisPaintX	ibis Paint X
jp.oniongames.hotel	Million Onion Hotel
jp.pokemon.pokemonhome	Pokémon HOME
karisma.dstaten.LeagueMVP	The League: Intelligent Dating
kunabi.EuclideanSkies	Euclidean Skies
leyi.westgame	West Game
link.merge.puzzle.onnect.number	Tile Connect - Classic Match
lma.Mixgram	Collage Maker - Mixgram Editor
lol.onevone	1v1.LOL - Build Battle Royale
lv.vdl.ogntr	Multiplayer Terraria edition
lwbrands.CDOT-Road-Conditions	CDOT Colorado Road Conditions
lwbrands.River-Levels	River Levels & Flows
lwbrands.radargun	Baseball Radar Gun +
lwbrandsllc.noaaforecast	NOAA Marine Forecast & Weather
m.qidian.QDReaderAppStore	起点读书-正版小说漫画阅读中文网
macys.ishop	Macy's
marnistek.AA-Speakers	AA Speakers - Speaker Tapes
mcdougalrecipes	Dr. McDougall Mobile Cookbook
me.dingtone.im	Dingtone - WiFi Calling & Text
me.fanzo.ripl	Ripl: Social Videos & Posts
me.id.auth	ID.me Authenticator
me.imgbase.intolive	intoLive - Live Wallpapers
me.jlabs.loudalarmclock2	Loud Alarm Clock Pro - Loudest
me.mycake	Cake - Learn English
me.pokeraid	PokeRaid - Raid From Home
me.pou.app	Pou
me.rapchat.RapChat	Rapchat: Song Maker Studio
me.talktone.im	TalkU: Unlimited Calls + Texts
me.tidesnear.paid	Tides Near Me - No Ads
me.zepeto.main	ZEPETO
mega.ios	・MEGA・
mertkacmaz.PlanetHours	Planetary Hours + Widget
mobapp.at.ArmyADPDELUXEEdition	Army study guide ArmyADP.com
mobi.MultiCraft	MultiCraft ― Build and Mine!
mobi.abcmouse.academy	ABCmouse.com
mobi.borisov.StrelokPro	Strelok Pro
mobi.byss.bbsoundfx	Ringtones for iPhone! (music)
mobi.digitalminds.itunerpro	myTuner Radio Pro
mobi.gameguru.elementflow	Element Flow
mobi.gameguru.streethustle	Street Hustle
mobi.mobilejump.freevpn	VPN - Super Unlimited Proxy
mobi.mobilejump.vpn	VPN - Unlimited Best VPN Proxy
moonbear.PocketBuild	Pocket Build
ms.games.minigore2	Minigore 2: Zombies
mspacman	Ms. PAC-MAN
mw.org.freewallet.app	Multi Crypto Wallet－Freewallet
mycity.airport	My City : Airport
mycity.babysitter	My City : Babysitter
mycity.friends	My City : Love Story
mycity.friendshouse	My City : My Friend's House
mycity.highschool	My City : High school
mycity.home	My City : Home
mycity.hospital	My City : Hospital
mycity.hotel	My City : Hotel
mycity.london	My City : London
mycity.mansion	My City : Mansion
mycity.newbornbaby	My City : Newborn Baby
mycity.newyork	My City : New York
mycity.pjparty	My City : Pajama Party
mycity.shopping	My City : Shopping Mall
mycity.wedding	My City : Wedding Party
myduaa	myDuaa: Fortress of a Muslim | حصن المسلم
mytown.airport	My Town : Airport
mytown.amusementpark	My Town : ICEME Amusement Park
mytown.beach	My Town : Beach Picnic
mytown.danceschool	My Town : Dance School
mytown.daycare	My Town : Daycare
mytown.friendshouse	My Town : Best Friends' House
mytown.grandparents	My Town : Grandparents
mytown.hauntedhouse	My Town : Haunted House
mytown.hospital	My Town : Hospital
mytown.hotel	My Town : Hotel
mytown.mall	My Town : Shopping Mall
mytown.museum	My Town : Museum
mytown.pets	My Town : Pets
mytown.police	My Town : Police
mytown.preschool	My Town : Preschool
mytown.school	My Town : School
mytown.stores	My Town : Stores
mytown.street	My Town : Street Fun
mytown.wedding	My Town : Wedding Day
net.Foddy.GettingOverIt	Getting Over It
net.WeatherMate.WeatherMate	Weather Mate Pro - Forecast
net.ajoy.kf	Cooking Madness-Kitchen Frenzy
net.champion.cubes	Cubes Empire Champions
net.cleverbit.SafariPuzzlesFull	Kids' Puzzles #2, Full Game
net.donwilson.Blackbird	Blackbird!
net.e-sword.e-Sword-LT	e-Sword LT: Bible Study to Go
net.flysher.rockncash	Rock N' Cash Casino Slots
net.gordonedwards.Scanner-Radio-Deluxe	Police Scanner Radio & Fire
net.healthxperts.ifitness.pro	Full Fitness : Exercise Workout Trainer
net.htwins.scale22	The Scale of the Universe 2
net.ichi2.anki	AnkiMobile Flashcards
net.icubemedia.receipt	Business Expense Tracker 3.0 with Custom Reports
net.iscannerapp.pro	iScanner - PDF Scanner App
net.kairosoft.iOS.baseballEN	Home Run High
net.kairosoft.iOS.basket	Basketball Club Story
net.kairosoft.iOS.bouken2	冒険ダンジョン村2
net.kairosoft.iOS.boxing	Boxing Gym Story
net.kairosoft.iOS.manga-ipponEN	The Manga Works
net.kortina.labs.Venmo	Venmo
net.liveatc.LiveATC	LiveATC Air Radio
net.machinarium.Machinarium	Machinarium
net.manta.comic	Manta Comics
net.mbc.shahid-iphone	Shahid - ﺷﺎﻫﺪ
net.metaquotes.MetaTrader4Terminal	MetaTrader 4
net.musictheory.Tenuto	Tenuto
net.musictheory.TheoryLessons	Theory Lessons
net.nugs.multiband	nugs.net
net.obdsoftware.obdfusion	OBD Fusion
net.orange-vallee.on.voicefeed	Libon - International calls
net.peakgames.SpadesPlus	Spades Plus - Card Game
net.peakgames.amy	Toy Blast
net.peakgames.ginrummyplus	Gin Rummy Plus - Card Game
net.peakgames.toonblast	Toon Blast
net.plantsnap.freemium	PlantSnap - identify plants
net.playables.kidsgame	KIDS⁢
net.playq.charmking	Charm King™
net.poopmap.poop-map	Poop Map - Pin and Track
net.riabinin.deck	Deck of Loteria
net.supertreat.solitaire	Solitaire Grand Harvest
net.techet.netanalyzer	Network Analyzer Pro
net.techet.sysstat	System Status Pro: hw monitor
net.tinywhale.Remote	GO Raid Party
net.wargaming.wotblitz	World of Tanks Blitz 3D War
net.wargaming.wowsblitz	World of Warships Blitz: MMO
net.windfinder.windfinderpro	Windfinder Pro: Wind & Weather
net.wooga.junes-journey-hidden-object-mystery-game	June's Journey: Hidden Objects
net.wooga.pearlsperil.phone	Pearl's Peril - Hidden Objects
net.zedge.wallpapers	ZEDGE™ Wallpapers
network.xyo.coin	COIN: Always Be Earning
nl.gamedia.hix	HIX: Puzzle Islands
nl.jeffreykuiken.ACNHTravelGuide	ACNH Travel Guide
no.mobitroll.kahoot.controller	Kahoot! Play & Create Quizzes
noe.guerrero.laserbeamphotofx	LASER SWORD PHOTO EDITOR FX + Light Glow and Laser Saber
nz.co.codepoint.minimetro	Mini Metro
org.alimentor.ParentLogMk03	Child Custody Log: Alimentor 2
org.asccp.app2019	ASCCP Management Guidelines
org.blubblub.app.speechblubs	Speech Blubs: Language Therapy
org.ccarnet.OmerApp	Omer: A Counting
org.celasSimplicity.toneAndSculpt	Tone & Sculpt
org.coursera.coursera	Coursera: Learn new skills
org.craigslist.CraigslistMobile	craigslist
org.fivefilters.pushtokindle-ios	Push for Kindle
org.fortheloss.sticknodespro	Stick Nodes Pro - Animator
org.freevpn.vpn	Free VPN by Free VPN .org™
org.fysh.GetRunning	Get Running
org.getpure.pure-iphone	PURE Hookup - anonymous dating
org.golfclash.notebook	Notebook for Golf Clash
org.hamstudy.mobile	HamStudy.org
org.hopelabs.Mood-Meter	The Mood Meter
org.ifsta.apparatus3examprepplus	Pumping and Aerial Apparatus Driver Operator 3rd Edition Exam Prep Plus
org.ifsta.e6examprep	Essentials of Fire Fighting 6th Edition Exam Prep Plus
org.ifsta.hmt2	HazMat Tech 2nd ed. Exam Prep+
org.ifsta.inst8examprep	Fire and Emergency Services Instructor 8th Edition Exam Prep Plus
org.ifsta.officer5examprepplus	Fire and Emergency Services Company Officer 5th Edition Exam Prep Plus
org.iggymedia.periodtracker	Flo Ovulation Period Tracker.
org.inaturalist.iNatLite	Seek by iNaturalist
org.kp.m	Kaiser Permanente
org.kurzgesagt.app.universe	Universe in a Nutshell
org.mozilla.ios.Firefox	Firefox: Private, Safe Browser
org.navyfederal.nfcuforiphone	Navy Federal Credit Union
org.pbskids.danieltigerpottyapp	Daniel Tiger's Stop & Go Potty
org.pbskids.wildkrattsrescuerun	Wild Kratts Rescue Run
org.pbskids.wildkrattsworldadventure	Wild Kratts World Adventure
org.reactjs.native.Inkitt.App.Colt	GALATEA - Addictive Stories
org.rotounderworld.dynastydominator	Dynasty Dominator
org.shellmuseum.shellzee	Shell Museum: Identify Shells
org.smapps.find	5 Differences Online
org.socratic.Socratic	Socratic by Google
org.toshi.distribution	Coinbase Wallet
org.whispersystems.signal	Signal - Private Messenger
org.xtramath.mathfacts	XtraMath
orgnarecoverycompanion	NA Recovery Companion
pampam.ibf2	Bottle Flip 3D!
patpat	PatPat - Kids & Baby Clothing
pdfreader.ipad.app	PDF Reader Pro Edition®
ph.telegra.Telegraph	Telegram Messenger
pihole.remote.app	Pi-hole Remote
pinterest	Pinterest
pl.idreams.JellyDefence	Jelly Defense
pl.idreams.potteryHD	Let's create! Pottery HD
plantidentifier.app	NatureID: Plant Identification
pm.spin	Spin - Electric Scooters
pr.ramajudicial.appunired	La Rama Judicial de Puerto Rico
pro.cryptobrowser.ios	CryptoTab Browser Pro
pw.katsu.katsu	KATSU by Orion
qr.code.barcode.reader.scanner	QR Code Reader & QR Scanner
ru.bnice.asolver-ios	ASolver>let's solve the puzzle
ru.denivip.denoise	Denoise - audio noise removal
ru.flysoft.ifunny	iFunny – hot memes and videos
ru.galya.drawjoust	Draw Joust!
ryan.AutoPad	AutoPad — Ambient Pad Loops
sanctuaryworld.co	Sanctuary Astrology: Psychic
sasanian.Hondata	Hondata
sasanian.Hondata-Complete	Hondata Complete
scannerapp.free	Scanner ·
se.illusionlabs.skate2	Touchgrind Skate 2
se.illusionlabs.touchgrindbmx2	Touchgrind BMX 2
se.raw-fury.kingdom-two-crown	Kingdom Two Crowns
se.resenatverket.FlightRadar24-Free	Flightradar24 | Flight Tracker
sepaul.Romulus-World	AP World History Review
sg.bigo.live	BIGO LIVE-Live Stream, Go Live
sh.weme.wemesh	Rave – Watch Party
sichtwerk.com.altimeter	Altimeter+
skydragon.honorofkings	Road of Kings - Endless Glory
slots.dcg.casino.games.free.ios	Jackpot Crush - Casino Slots
slots.diamondlife.casino.games.ios	Lotsa Slots™ - Vegas Casino
slots.free.vegas.casino.jackpot.link.ios	Cash Mania: Slots Casino Games
slots.games.vegas.night.casino	Jackpot World™ - Casino Slots
slots.machine.winning.ios	Winning Slots Las Vegas Casino
slots.secretsauce.casino.games.free.ios	Cash Frenzy™ - Slots Casino
soccer.score.star	Soccer Super Star
socusoft.com.PhotoDirector	Photo Slideshow Director
solutions.laro.OneRepost	Repost for Instagram #Repost
solutions.wzp.translator	Translate Now - Translator
sowah.karen-hymn	karen hymn
speedClock	SpeedClock - Video Radar
sprint.car.racing	Outlaws - Sprint Car Racing 3
sprintTimer	SprintTimer - Photo Finish
studiofurukawa.pixelcarracer	Pixel Car Racer
tech.hypergames.lifesim2	LifeSim 2: Real Life Simulator
tech.plink.PlinkApp	PLINK - Connecting Gamers
tech.schrade.flexwidgets	Flex Widgets
testme.app	Futurio: Daily Horoscope 2021
text.free.international.second.phone	Text App:Now Calling+Texting
tiennvan.FakeMessages	iFake - Funny Fake Messages Creator
timl.copy	Fonts by Fontkey | Chat & IG
top.cheyoujia.chejiajia	CAR++
tv.caffeine.Ana	Caffeine: Live Streaming
tv.fubo.mobile	fuboTV: Watch Live Sports & TV
tv.lifechurch.bible	Bible
tv.pluto.ios	Pluto TV - Live TV and Movies
tv.telepathic.hooked	Hooked
tv.thesecret.dailyteachings	The Secret Daily Teachings
tv.thesecret.money	The Secret To Money
tv.twitch	Twitch: Live Game Streaming
tv.yokee.karaoke	Karaoke - Sing Unlimited Songs
uk.co.christianhypnobirthing.iosoverview	Christian Hypnobirthing
uk.co.focusmm.DTSComboiPhone	Driving Theory Test 4 in 1 Kit
uk.co.frontier.rct3	RollerCoaster Tycoon® 3
uk.co.omnichrome.beeplus	BeePlus Beekeeping Manager
uk.co.test-alpha.wifiblocker	WiFi Blocker
uk.co.tso.itilfourfoundation	Official ITIL 4 Foundation App
us.bark.barkconnectiosapp	Bark - Parental Controls
us.binance.fiat	Binance.US - Bitcoin & Crypto
us.kr.baseballnine	BASEBALL 9
us.mobilepassport.ios	Mobile Passport
us.parkmobile.ParkMobile	ParkMobile - Find Parking
us.pixomaticpro.PixomaticPro	Pixomatic - Background Changer
us.zoom.videomeetings	ZOOM Cloud Meetings
us.zoom.videomeetings4intune	Zoom for Intune
video.chat.gaze	Gaze - Video Chat
video.chat.joi	Joi - Live Video Chat
video.like	Likee - Let You Shine
videochatiOS90001	LivU - Fun Live Video Chat
videoeditor.app	Video Editor ·
vo.threes.exclaim	Threes!
vochi.effects	VOCHI Cool Video Effects Maker
vt.free	Voice Translator App.
war.of.islands	War of Rafts: Naval Battle
watch.podcasts	Outcast for Watch
wbmedia.MyTalkingPetFree	My Talking Pet
wildfires.lwbrandsllc	Wildfire - Fire Map Info
wind.vpn	Wind VPN - Security Assistant
world.playme.mechat	MeChat - Love secrets
write.read.story.webnovel.book.anystories	AnyStories
ws.drool.thumper	Thumper: Pocket Edition
www.wheelroad.wheeloffroad	Wheel Offroad
xyz.plantin.app	PlantIn: Plant Identifier
xyz.screenkit.screenkit	ScreenKit- App Icons & Widgets
yio.tro.vodobankapro	Vodobanka Pro
zgames.dirt.track.racing	Outlaws - Dirt Track Racing 3
zombie.survival.craft.z	Last Day on Earth: Survival
zombiegun3d	Pixel Gun 3D: Fun Action Game
zzkko.com.ZZKKO	SHEIN-Fashion Shopping Online